type,amount,narration,currentBalance,transactionTimestamp,txnId,mode,reference,valueDate
DEBIT,1050.0,UPI-AYAN SHEIKH-AYAN.SHEIKH@YBL-SBIN2508461-03692464306,36572.78,2022-01-13T09:57:40+05:30,,OTHER,,2022-01-13
DEBIT,1050.0,EAW-381510XXXXXX7741-CPCN6427-BHARUCH,35522.78,2022-01-15T07:10:06+05:30,,OTHER,,2022-01-915
DEBIT,603.75,UPI-PLAYERZPOT MEDIA PVT-PLAYERZPOT@PAYTM-PYTM8576012-133572,34919.03,2022-01-15T09:07:50+05:30,,OTHER,,2022-01-15
CREDIT,1050.0,IMPS-803782298818-FIDUCIARY BILLING SO-YESB-XXXXXXXXXXX1143-,35969.03,2022-01-15T09:25:34+05:30,,OTHER,,2022-01-15
CREDIT,5250.0,IMPS-791730016004-Prasad Rathod-PYTM-XXXXXXXXXX2721-DOMESTIC,41219.03,2022-01-15T10:48:22+05:30,,OTHER,,2022-01-15
CREDIT,2100.0,IMPS-086762451065-Artha Pal-PYTM-XXXXXXXXXX4441-DOMESTIC,43319.03,2022-01-15T10:48:26+05:30,,OTHER,,2022-01-15
CREDIT,315.0,IMPS-434578327845-FIDUCIARY BILLING SO-YESB-XXXXXXXXXXX2887-,43634.03,2022-01-16T03:43:54+05:30,,OTHER,,2022-01-16
DEBIT,1575.0,UPI-KIRAN BHANUSHALI-0504542886@YBL-SBIN7865881-578390691820,42059.03,2022-01-16T08:39:51+05:30,,OTHER,,2022-01-16
DEBIT,603.75,UPI-PLAYERZPOT MEDIA PVT-PLAYERZPOT@PAYTM-PYTM3570295-456195,41455.28,2022-01-16T13:37:05+05:30,,OTHER,,2022-01-16
CREDIT,1123.5,IMPS-135472022003-Prasad Yadav 4-ICIC-XXXXXXXX0495-PLA,42578.78,2022-01-16T15:26:22+05:30,,OTHER,,2022-01-16
CREDIT,315.0,IMPS-159119477949-FIDUCIARY BILLING SO-YESB-XXXXXXXXXXX3347-,42893.78,2022-01-16T15:26:48+05:30,,OTHER,,2022-01-16
DEBIT,7339.5,UPI-KARPIT PATEL-KARPIT.PATEL@OKICICI-ICIC2596618-,35554.28,2022-01-17T03:47:22+05:30,,OTHER,,2022-01-17
DEBIT,1271.55,ACH D- LIC OF INDIA-4830182269979,34282.73,2022-01-17T04:46:15+05:30,,OTHER,,2022-01-17
DEBIT,315.0,UPI-DREAM11-DREAM11ONLINE@YBL-YESB0YBLUPI-134136603855-PAYME,33967.73,2022-01-17T08:15:17+05:30,,OTHER,,2022-01-17
DEBIT,15445.5,EMI 0719132   CHQ S73950303282 47274256231,18522.23,2022-01-17T09:45:16+05:30,,OTHER,,2022-01-17
DEBIT,126.0,UPI-PLAYERZPOT MEDIA PVT-PLAYERZPOT@PAYTM-PYTM1978050-275224,18396.23,2022-01-17T13:19:36+05:30,,OTHER,,2022-01-17
DEBIT,488.25,KQSX35EIBN69FOOXCI/PAYUAMAZON,17907.98,2022-01-17T14:26:51+05:30,,OTHER,,2022-01-17
DEBIT,2.1,UPI-DREAM11-DREAM11ONLINE@YBL-YESB0YBLUPI-134167587254-PAYME,17905.88,2022-01-17T14:33:45+05:30,,OTHER,,2022-01-17
CREDIT,246.75,IMPS-966080495631-Avan Kumar 2-ICIC-XXXXXXXX7307-PLA,18152.63,2022-01-17T16:09:11+05:30,,OTHER,,2022-01-17
DEBIT,262.5,UPI-Farid Rathod-CF.BLOSSOMFIELDGAMINGZ@INDUS-INDB74,17890.13,2022-01-18T03:22:22+05:30,,OTHER,,2022-01-18
DEBIT,220.5,UPI-DREAM11-DREAM11ONLINE@YBL-YESB0YBLUPI-134217244267-PAYME,17669.63,2022-01-18T07:43:55+05:30,,OTHER,,2022-01-18
DEBIT,357.0,UPI-DREAM11-DREAM11ONLINE@YBL-YESB0YBLUPI-134283032300-PAYME,17312.63,2022-01-18T09:40:51+05:30,,OTHER,,2022-01-18
DEBIT,7693.35,IB BILLPAY DR-HDFCYA-784557XXXXXX0258,9619.28,2022-01-18T12:40:02+05:30,,OTHER,,2022-01-18
DEBIT,1050.0,NWD-591879XXXXXX4540-MPB55069-GADKHOL,8569.28,2022-01-19T06:54:12+05:30,,OTHER,,2022-01-19
DEBIT,61.95,UPI-BHARTI AIRTEL LIMITE-AIRTELPREDIRECT9@YBL-YESB8YBLUPI-10,8507.33,2022-01-20T08:53:10+05:30,,OTHER,,2022-01-20
DEBIT,3675.0,UPI-KIRAN BHANUSHALI-3597821321@YBL-SBIN3884506-789393132936,4832.33,2022-01-21T05:50:09+05:30,,OTHER,,2022-01-21
DEBIT,1048.95,UPI-DREAM11-DREAM11ONLINE@YBL-YESB0YBLUPI-134507294538-PAYME,3783.38,2022-01-21T10:55:38+05:30,,OTHER,,2022-01-21
DEBIT,161.7,311634951428181/CITRUSZOMATOCOM,3621.68,2022-01-21T18:21:09+05:30,,OTHER,,2022-01-21
DEBIT,12600.0,CC 144864941XXXXXX4930 AUTOPAY SI-TAD,-8978.32,2022-01-22T07:11:23+05:30,,OTHER,,2022-01-22
CREDIT,12600.0,CC 737853155XXXXXX9296 AUTOPAY SI-TAD,3621.68,2022-01-22T07:11:23+05:30,,OTHER,,2022-01-22
DEBIT,3334.8,CC 669769699XXXXXX5936 AUTOPAY SI-TAD,286.88,2022-01-22T07:44:29+05:30,,OTHER,,2022-01-22
CREDIT,1050.0,IMPS-904234256317-FIDUCIARY BILLING SO-YESB-XXXXXXXXXXX7055-,1336.88,2022-01-23T02:51:44+05:30,,OTHER,,2022-01-23
DEBIT,5.25,UPI-DREAM11-DREAM11ONLINE@YBL-YESB0YBLUPI-134769278743-PAYME,1331.63,2022-01-23T10:10:28+05:30,,OTHER,,2022-01-23
DEBIT,52.5,UPI-DREAM11-DREAM11ONLINE@YBL-YESB0YBLUPI-134735722970-PAYME,1279.13,2022-01-23T10:11:25+05:30,,OTHER,,2022-01-23
DEBIT,316.05,UPI-YKUX RUMMY-PAYTM-45112997@PAYTM-PYTM3846398-980924870974,963.08,2022-01-23T12:34:38+05:30,,OTHER,,2022-01-23
CREDIT,371.7,IMPS-430794394418-FIDUCIARY BILLING SO-YESB-XXXXXXXXXXX6351-,1334.78,2022-01-23T12:52:28+05:30,,OTHER,,2022-01-23
DEBIT,315.0,UPI-DREAM11-DREAM11ONLINE@YBL-YESB0YBLUPI-134741681516-PAYME,1019.78,2022-01-23T13:11:54+05:30,,OTHER,,2022-01-23
DEBIT,316.05,UPI-MOJOOPOOL-PAYTM-76705793@PAYTM-PYTM1758205-759565103747-,703.73,2022-01-23T13:19:58+05:30,,OTHER,,2022-01-23
DEBIT,316.05,UPI-YKUX RUMMY-PAYTM-48353294@PAYTM-PYTM1521974-760753670594,387.68,2022-01-23T13:41:35+05:30,,OTHER,,2022-01-23
DEBIT,316.05,UPI-YKUX RUMMY-PAYTM-37641190@PAYTM-PYTM9711706-209254589895,71.63,2022-01-23T18:36:24+05:30,,OTHER,,2022-01-23
CREDIT,210.0,UPI-DEEPIKA PADUKON-0155861464@IBL-KKBK7342269-07124249,281.63,2022-01-24T07:48:52+05:30,,OTHER,,2022-01-24
DEBIT,316.05,UPI-RUMMYOKING-PAYTM-25061227@PAYTM-PYTM2059455-899971966390,-34.42,2022-01-24T07:51:15+05:30,,OTHER,,2022-01-24
DEBIT,349.65,UPI-DREAM11-DREAM11ONLINE@YBL-YESB0YBLUPI-134847088364-PAYME,-384.07,2022-01-24T13:11:16+05:30,,OTHER,,2022-01-24
DEBIT,5.25,UPI-DREAM11-DREAM11ONLINE@YBL-YESB0YBLUPI-134871684128-PAYME,-389.32,2022-01-24T13:11:45+05:30,,OTHER,,2022-01-24
CREDIT,136.5,UPI-DEEPIKA PADUKON-4392518344@IBL-KKBK4256233-56281445,-252.82,2022-01-24T13:34:25+05:30,,OTHER,,2022-01-24
DEBIT,215.25,UPI-SPORTA TECHNOLOGIES -DREAM11UPI@KOTAK-KKBK0000958-134866,-468.07,2022-01-24T13:59:15+05:30,,OTHER,,2022-01-24
DEBIT,211.05,UPI-MOJOOPOOL-PAYTM-78447831@PAYTM-PYTM7544632-774311532922-,-679.12,2022-01-24T18:30:56+05:30,,OTHER,,2022-01-24
DEBIT,211.05,UPI-YKUX RUMMY-PAYTM-84725983@PAYTM-PYTM5314566-349322504972,-890.17,2022-01-25T04:54:38+05:30,,OTHER,,2022-01-25
DEBIT,346.5,UPI-DREAM11-DREAM11@YESPAY-YESB0YESUPI-135097841807-PAYING T,-1236.67,2022-01-26T13:10:04+05:30,,OTHER,,2022-01-26
DEBIT,211.05,UPI-YKUX RUMMY-PAYTM-60853550@PAYTM-PYTM3102304-875289260402,-1447.72,2022-01-26T14:02:17+05:30,,OTHER,,2022-01-26
CREDIT,105.0,UPI-RANVEER SINGH-SINGHPIRIMID@OKSBI-SBIN2939304-0293311448,-1342.72,2022-01-26T15:18:38+05:30,,OTHER,,2022-01-26
CREDIT,1060.5,IMPS-006917065102-FIDUCIARY BILLING SO-YESB-XXXXXXXXXXX7857-,-282.22,2022-01-26T17:19:29+05:30,,OTHER,,2022-01-26
DEBIT,644.7,UPI-SWAMINARAYANDIPARTME-Q16571687@YBL-YESB1YBLUPI-064370703,-926.92,2022-01-27T07:22:16+05:30,,OTHER,,2022-01-27
CREDIT,644.7,UPI-Prasad Sahu-HP975007@OKSBI-SBIN5762771-15164860,-282.22,2022-01-27T10:00:34+05:30,,OTHER,,2022-01-27
CREDIT,262.5,UPI-Aadhira Ansari-HP065362@OKSBI-SBIN0464239-53211791,-19.72,2022-01-27T10:54:20+05:30,,OTHER,,2022-01-27
DEBIT,241.5,UPI-DREAM11-DREAM11@YESPAY-YESB0YESUPI-135115335665-PAYING T,-261.22,2022-01-27T14:14:45+05:30,,OTHER,,2022-01-27
CREDIT,630.0,IMPS-931266937352-FIDUCIARY BILLING SO-YESB-XXXXXXXXXXX0515-,368.78,2022-01-27T18:03:29+05:30,,OTHER,,2022-01-27
DEBIT,241.5,UPI-DREAM11-DREAM11@YESPAY-YESB0YESUPI-135219613336-PAYING T,127.28,2022-01-28T01:53:02+05:30,,OTHER,,2022-01-28
CREDIT,630.0,IMPS-111016483178-FIDUCIARY BILLING SO-YESB-XXXXXXXXXXX7991-,757.28,2022-01-28T05:13:25+05:30,,OTHER,,2022-01-28
DEBIT,280.35,UPI-BHARTI AIRTEL LIMITE-AIRTELPREDIRECT0@YBL-YESB1YBLUPI-25,476.93,2022-01-28T05:59:42+05:30,,OTHER,,2022-01-28
CREDIT,280.35,UPI-Ishani Lal-0474280834@IBL-SBIN4875596-915161886125-PA,757.28,2022-01-28T08:24:48+05:30,,OTHER,,2022-01-28
DEBIT,126.0,UPI-PLAYERZPOT MEDIA PVT-PLAYERZPOT@PAYTM-PYTM9312497-322446,631.28,2022-01-29T02:48:39+05:30,,OTHER,,2022-01-29
DEBIT,94.5,UPI-PLAYERZPOT MEDIA PVT-PLAYERZPOT@PAYTM-PYTM1802226-088439,536.78,2022-01-29T09:46:19+05:30,,OTHER,,2022-01-29
DEBIT,805.35,DEBIT CARD ANNUAL FEE-NOV-7186 065600-MIR4094750938828,-268.57,2022-01-30T06:17:57+05:30,,OTHER,,2022-01-30
DEBIT,406.35,UPI-DREAM11-DREAM11@YESPAY-YESB0YESUPI-135454885247-PAYING T,-674.92,2022-01-30T08:04:42+05:30,,OTHER,,2022-01-30
DEBIT,42.0,UPI-PLAYERZPOT MEDIA PVT-PLAYERZPOT@PAYTM-PYTM8164180-705457,-716.92,2022-01-30T11:04:42+05:30,,OTHER,,2022-01-30
DEBIT,603.75,UPI-PLAYERZPOT MEDIA PVT-PLAYERZPOT@PAYTM-PYTM6340449-464161,-1320.67,2022-01-30T12:58:36+05:30,,OTHER,,2022-01-30
CREDIT,1575.0,UPI-KIRAN BHANUSHALI-7695170489@YBL-SBIN7460121-319694634333,254.33,2022-01-31T10:53:40+05:30,,OTHER,,2022-01-31
DEBIT,1575.0,UPI-Deven Devi-2446936238@YBL-UBIN5328699-97948042,-1320.67,2022-01-31T10:57:19+05:30,,OTHER,,2022-01-31
CREDIT,5250.0,UPI-RAM RAHIM-6268205269@YBL-SBIN2066909-72778638,3929.33,2022-01-31T11:38:34+05:30,,OTHER,,2022-01-31
DEBIT,253.05,UPI-BHARTI AIRTEL LIMITE-AIRTELPREDIRECT0@YBL-YESB0YBLUPI-49,3676.28,2022-02-01T08:46:09+05:30,,OTHER,,2022-02-01
DEBIT,42.0,UPI-BHARATPEMERCHANT-BHARATPE.4223540806@ICICI-ICIC4746307-0,3634.28,2022-02-01T14:44:45+05:30,,OTHER,,2022-02-01
DEBIT,126.0,UPI-Sudhir Paramar-RAZORPAYONLINE@YBL-YESB5YBLUPI-7480,3508.28,2022-02-01T15:20:52+05:30,,OTHER,,2022-02-01
DEBIT,42.0,UPI-Drisana Ghosh-RAZORPAYONLINE@YBL-YESB7YBLUPI-4284,3466.28,2022-02-01T18:34:16+05:30,,OTHER,,2022-02-01
DEBIT,603.75,UPI-Yanisha Devi-RAZORPAYONLINE@YBL-YESB1YBLUPI-9554,2862.53,2022-02-02T12:58:31+05:30,,OTHER,,2022-02-02
DEBIT,131.25,UPI-DREAM11-DREAM11ONLINE@YBL-YESB0YBLUPI-135714631439-PAYME,2731.28,2022-02-02T14:03:15+05:30,,OTHER,,2022-02-02
DEBIT,131.25,UPI-DREAM11-DREAM11ONLINE@YBL-YESB0YBLUPI-135708438502-PAYME,2600.03,2022-02-02T14:07:27+05:30,,OTHER,,2022-02-02
CREDIT,1002.75,IMPS-962566933023-Vivan Thakur PVT LTD-YESB-XXXXXXXXXXX5453-PLAYERZP,3602.78,2022-02-02T14:36:33+05:30,,OTHER,,2022-02-02
CREDIT,210.0,IMPS-065272683435-FIDUCIARY BILLING SO-YESB-XXXXXXXXXXX3494-,3812.78,2022-02-02T17:39:56+05:30,,OTHER,,2022-02-02
DEBIT,126.0,UPI-Aditi Devi-RAZORPAYONLINE@YBL-YESB2YBLUPI-7068,3686.78,2022-02-02T17:41:21+05:30,,OTHER,,2022-02-02
DEBIT,87.15,UPI-Neha Ansari-RAZORPAYONLINE@YBL-YESB6YBLUPI-3477,3599.63,2022-02-03T03:28:15+05:30,,OTHER,,2022-02-03
DEBIT,406.35,UPI-DREAM11-DREAM11ONLINE@YBL-YESB0YBLUPI-135840009339-PAYME,3193.28,2022-02-03T04:41:29+05:30,,OTHER,,2022-02-03
DEBIT,80.85,UPI-Kimaya Patel-RAZORPAYONLINE@YBL-YESB4YBLUPI-4501,3112.43,2022-02-03T05:20:50+05:30,,OTHER,,2022-02-03
DEBIT,15.75,UPI-Tanaia Das-EURONET@YBL-YESB4YBLUPI-697216174671-PAYMENT FRO,3096.68,2022-02-03T11:35:00+05:30,,OTHER,,2022-02-03
DEBIT,105.0,UPI-Kamala Mahato-RAZORPAYONLINE@YBL-YESB6YBLUPI-0049,2991.68,2022-02-03T12:01:54+05:30,,OTHER,,2022-02-03
CREDIT,393.75,IMPS-152202228048-Mihir Paramar PVT LTD-YESB-XXXXXXXXXXX7879-PLAYERZP,3385.43,2022-02-03T16:59:47+05:30,,OTHER,,2022-02-03
DEBIT,525.0,UPI-KIRAN BHANUSHALI-3713523193@YBL-SBIN1768373-323742700311,2860.43,2022-02-04T05:58:46+05:30,,OTHER,,2022-02-04
DEBIT,126.0,UPI-Aadhira Lal-RAZORPAYONLINE@YBL-YESB7YBLUPI-9296,2734.43,2022-02-04T09:39:35+05:30,,OTHER,,2022-02-04
DEBIT,42.0,UPI-Salina Patil-RAZORPAYONLINE@YBL-YESB2YBLUPI-8889,2692.43,2022-02-04T13:33:35+05:30,,OTHER,,2022-02-04
DEBIT,94.5,UPI-BHARATPEMERCHANT-BHARATPE.9111196633@ICICI-ICIC1499586-7,2597.93,2022-02-04T14:36:57+05:30,,OTHER,,2022-02-04
CREDIT,456.75,IMPS-757197153260-Kamala Barman PVT LTD-YESB-XXXXXXXXXXX1686-PLAYERZP,3054.68,2022-02-04T22:28:20+05:30,,OTHER,,2022-02-04
DEBIT,190.05,UPI-Charu Rathod-EURONET@YBL-YESB9YBLUPI-486853264309-PAYMENT FRO,2864.63,2022-02-05T13:22:18+05:30,,OTHER,,2022-02-05
DEBIT,126.0,UPI-Deven Mahto-RAZORPAYONLINE@YBL-YESB4YBLUPI-8390,2738.63,2022-02-05T15:39:52+05:30,,OTHER,,2022-02-05
DEBIT,42.0,UPI-Drisana Biswas-RAZORPAYONLINE@YBL-YESB2YBLUPI-7131,2696.63,2022-02-05T16:47:36+05:30,,OTHER,,2022-02-05
DEBIT,4200.0,UPI-RUTVIK SINGH-RUTVIK.SINGH414@OKICICI-ICIC046,-1503.37,2022-02-06T04:20:49+05:30,,OTHER,,2022-02-06
DEBIT,126.0,UPI-Damayanti Sarkar-RAZORPAYONLINE@YBL-YESB4YBLUPI-3906,-1629.37,2022-02-06T12:54:48+05:30,,OTHER,,2022-02-06
DEBIT,126.0,UPI-Deven Das-RAZORPAYONLINE@YBL-YESB5YBLUPI-9992,-1755.37,2022-02-06T13:19:59+05:30,,OTHER,,2022-02-06
CREDIT,372.75,IMPS-598241083949-Devi Mahto PVT LTD-YESB-XXXXXXXXXXX8884-PLAYERZP,-1382.62,2022-02-06T14:40:38+05:30,,OTHER,,2022-02-06
DEBIT,157.5,UPI-DREAM11-DREAM11@YESPAY-YESB0YESUPI-136107499204-PAYING T,-1540.12,2022-02-06T15:09:28+05:30,,OTHER,,2022-02-06
DEBIT,126.0,UPI-Mayur Singh-RAZORPAYONLINE@YBL-YESB6YBLUPI-4007,-1666.12,2022-02-06T15:54:54+05:30,,OTHER,,2022-02-06
DEBIT,126.0,UPI-Artha Thakur-RAZORPAYONLINE@YBL-YESB4YBLUPI-7172,-1792.12,2022-02-06T18:48:42+05:30,,OTHER,,2022-02-06
CREDIT,105.0,UPI-DEEPIKA PADUKON-2420167561@IBL-KKBK2833086-14190836,-1687.12,2022-02-07T14:29:20+05:30,,OTHER,,2022-02-07
DEBIT,105.0,UPI-Tanaia Rani-CASHFREENMODELTEC@YESBANK-YESB2755054-3873476,-1792.12,2022-02-07T14:37:19+05:30,,OTHER,,2022-02-07
DEBIT,10.5,UPI-KIRAN BHANUSHALI-2543220528@YBL-SBIN2027149-249579922270,-1802.62,2022-02-07T14:58:58+05:30,,OTHER,,2022-02-07
CREDIT,918.75,IMPS-262334369370-Candy Barman PVT LTD-YESB-XXXXXXXXXXX7668-PLAYERZP,-883.87,2022-02-08T10:50:24+05:30,,OTHER,,2022-02-08
DEBIT,42.0,UPI-Shalena Ma-RAZORPAYONLINE@YBL-YESB1YBLUPI-0585,-925.87,2022-02-08T13:15:45+05:30,,OTHER,,2022-02-08
DEBIT,882.0,IB BILLPAY DR-HDFCYA-075964XXXXXX6522,-1807.87,2022-02-08T13:34:00+05:30,,OTHER,,2022-02-08
CREDIT,456.75,IMPS-563903238811-Kaan Mahato PVT LTD-YESB-XXXXXXXXXXX4132-PLAYERZP,-1351.12,2022-02-09T15:52:54+05:30,,OTHER,,2022-02-09
DEBIT,472.5,IB BILLPAY DR-HDFCYA-622273XXXXXX8177,-1823.62,2022-02-09T15:55:17+05:30,,OTHER,,2022-02-09
CREDIT,50596.35,NEFT CR-BOFA7ND7331-PIRIMID FINTECH INDIA PVT LTD-KEVAL PUROHIT RAI-38C,48772.73,2022-02-10T07:33:19+05:30,,OTHER,,2022-02-10
DEBIT,10500.0,UPI-DARSHAN SHARMA-SHARMA7916@OKHDFCBANK-HDFC1911942-908509,38272.73,2022-02-10T11:45:23+05:30,,OTHER,,2022-02-10
DEBIT,3720.58,IB BILLPAY DR-HDFCCC-473682XXXXXX2047,34552.15,2022-02-10T11:47:33+05:30,,OTHER,,2022-02-10
DEBIT,377.03,UPI-ZOMATO-ZOMATO@HDFCBANK-HDFC2139640-901082680520-ZOMATOON,34175.12,2022-02-10T16:36:40+05:30,,OTHER,,2022-02-10
CREDIT,94.5,CREDIT INTEREST CAPITALISED,34269.62,2022-02-10T21:35:40+05:30,,OTHER,,2022-02-10
DEBIT,73.5,UPI-JODHPUR JALEBI-GPAY-59019048246@OKBIZAXIS-UTIB2816061-98,34196.12,2022-02-11T05:26:05+05:30,,OTHER,,2022-02-11
DEBIT,249.9,UPI-SHIVAM DAIRY-PAYTMQR2506971806095DUPNZ2XT75R@PAYTM-PYTM3,33946.22,2022-02-11T07:17:43+05:30,,OTHER,,2022-02-11
DEBIT,6.3,UPI-VIJAYBHAI PUJABHAI P-PAYTMQR292154818231ZR0B52C7ACN9@PAY,33939.92,2022-02-11T07:56:25+05:30,,OTHER,,2022-02-11
DEBIT,183.54,UPI-ZOMATO LTD-ZOMATO-ORDER@PAYTM-PYTM9859907-224649288417-Z,33756.38,2022-02-11T09:20:10+05:30,,OTHER,,2022-02-11
DEBIT,1.05,UPI-XXXXXX3900-HDFC6976849-945653198437-PAYMENT FROM PHONE,33755.33,2022-02-12T05:43:06+05:30,,OTHER,,2022-02-12
DEBIT,7350.0,UPI-XXXXXX7937-HDFC4956452-796185977822-PAYMENT FROM PHONE,26405.33,2022-02-12T05:49:28+05:30,,OTHER,,2022-02-12
DEBIT,262.5,UPI-Sahil Sarkar-6354138845@YBL-PYTM7345984-622638977972-PAYMENT F,26142.83,2022-02-12T05:56:07+05:30,,OTHER,,2022-02-12
DEBIT,105.0,UPI-MR PARESHBHAI GEETES-Q08473995@YBL-CBIN0095535-743701170,26037.83,2022-02-12T11:08:26+05:30,,OTHER,,2022-02-12
DEBIT,840.0,UPI-Ambar Rathod-0859409317@YBL-HDFC1581066-132499507053-,25197.83,2022-02-12T15:43:13+05:30,,OTHER,,2022-02-12
DEBIT,505.05,UPI-Candy Kaur-EURONET@YBL-YESB7YBLUPI-883494022569-PAYMENT FRO,24692.78,2022-02-13T05:08:28+05:30,,OTHER,,2022-02-13
CREDIT,2100.0,UPI-JENISH VEKARIYA-1217079960@YBL-HDFC6461322-817076555869,26792.78,2022-02-13T07:25:06+05:30,,OTHER,,2022-02-13
DEBIT,2310.0,UPI-Shaleena Saha-7282410123@YBL-CNRB7188770-0380773688,24482.78,2022-02-13T08:09:41+05:30,,OTHER,,2022-02-13
DEBIT,60.9,UPI-DAVID PATEL-0887182547@YBL-HDFC1946243-91529603,24421.88,2022-02-13T12:36:12+05:30,,OTHER,,2022-02-13
DEBIT,1050.0,EAW-261055XXXXXX3877-CPRH3570-BHARCH,23371.88,2022-02-13T18:09:27+05:30,,OTHER,,2022-02-13
DEBIT,406.35,UPI-DREAM11-DREAM11ONLINE@YBL-YESB0YBLUPI-200441870317-PAYME,22965.53,2022-02-14T13:58:52+05:30,,OTHER,,2022-02-14
DEBIT,210.0,UPI-Shalene Kaur-SHALENE29@OKSBI-SBIN4773779-28753398,22755.53,2022-02-14T15:19:58+05:30,,OTHER,,2022-02-14
DEBIT,30.45,UPI-SHIVAM DAIRY-PAYTMQR5132293507915DUPNZ9XT87R@PAYTM-PYTM7,22725.08,2022-02-15T05:16:34+05:30,,OTHER,,2022-02-15
DEBIT,409.5,UPI-DREAM11-DREAM11ONLINE@YBL-YESB0YBLUPI-200537654167-PAYME,22315.58,2022-02-15T08:13:59+05:30,,OTHER,,2022-02-15
DEBIT,126.0,UPI-Manu Pal-RAZORPAYONLINE@YBL-YESB0YBLUPI-3983,22189.58,2022-02-15T12:20:26+05:30,,OTHER,,2022-02-15
CREDIT,849.45,IMPS-302525051235-FIDUCIARY BILLING SO-YESB-XXXXXXXXXXX9763-,23039.03,2022-02-15T15:51:42+05:30,,OTHER,,2022-02-15
CREDIT,414.75,IMPS-790850926875-Amata Shaikh PVT LTD-YESB-XXXXXXXXXXX9631-PLAYERZP,23453.78,2022-02-15T16:38:56+05:30,,OTHER,,2022-02-15
CREDIT,367.5,IMPS-227869104092-FIDUCIARY BILLING SO-YESB-XXXXXXXXXXX1932-,23821.28,2022-02-15T16:39:23+05:30,,OTHER,,2022-02-15
DEBIT,30.45,UPI-DAVID PATEL-4421720602@YBL-HDFC0700345-73370064,23790.83,2022-02-15T18:21:27+05:30,,OTHER,,2022-02-15
DEBIT,126.0,UPI-Manu Rani-RAZORPAYONLINE@YBL-YESB3YBLUPI-1565,23664.83,2022-02-15T19:08:03+05:30,,OTHER,,2022-02-15
DEBIT,126.0,UPI-Kashvi Lal-RAZORPAYONLINE@YBL-YESB9YBLUPI-6129,23538.83,2022-02-16T04:27:29+05:30,,OTHER,,2022-02-16
DEBIT,4935.0,UPI-KARPIT PATEL-KARPIT709@OKICICI-ICIC8225663-,18603.83,2022-02-16T06:14:19+05:30,,OTHER,,2022-02-16
DEBIT,241.5,UPI-DREAM11-DREAM11ONLINE@YBL-YESB0YBLUPI-200675419544-PAYME,18362.33,2022-02-16T07:19:27+05:30,,OTHER,,2022-02-16
DEBIT,815.85,UPI-DREAM11-DREAM11ONLINE@YBL-YESB0YBLUPI-200630805979-PAYME,17546.48,2022-02-16T10:24:33+05:30,,OTHER,,2022-02-16
DEBIT,126.0,UPI-PLAYERZPOT MEDIA PVT-PLAYERZPOTMEDIA.RZP@YESBANK-YESB372,17420.48,2022-02-16T13:46:38+05:30,,OTHER,,2022-02-16
CREDIT,1165.5,IMPS-257184709224-Tej Rathod PVT LTD-YESB-XXXXXXXXXXX0929-PLAYERZP,18585.98,2022-02-16T18:36:30+05:30,,OTHER,,2022-02-16
DEBIT,30.45,UPI-DAVID PATEL-4214783400@YBL-HDFC0283376-45882940,18555.53,2022-02-16T23:07:47+05:30,,OTHER,,2022-02-16
DEBIT,126.0,UPI-Shaleena Kaur-RAZORPAYONLINE@YBL-YESB7YBLUPI-7280,18429.53,2022-02-17T03:08:43+05:30,,OTHER,,2022-02-17
DEBIT,126.0,UPI-Kashvi Kumari-RAZORPAYONLINE@YBL-YESB4YBLUPI-1091,18303.53,2022-02-17T03:35:57+05:30,,OTHER,,2022-02-17
DEBIT,1271.55,ACH D- LIC OF INDIA-6319899715884,17031.98,2022-02-17T04:12:38+05:30,,OTHER,,2022-02-17
CREDIT,2415.0,UPI-Anala Ram-8709703221@YBL-HDFC7535329-000423686279-PAY,19446.98,2022-02-17T07:48:37+05:30,,OTHER,,2022-02-17
DEBIT,15445.5,EMI 9107829   CHQ S10886519770 83057894539,4001.48,2022-02-17T08:21:29+05:30,,OTHER,,2022-02-17
CREDIT,525.0,UPI-NIKOLA KOVAC-NIKO.AJ@OKAXIS-SBIN7994764-02968156115,4526.48,2022-02-17T09:05:03+05:30,,OTHER,,2022-02-17
CREDIT,525.0,UPI-Divya Pal-5666659869@IBL-SBIN5490365-233618772123-PA,5051.48,2022-02-17T09:05:16+05:30,,OTHER,,2022-02-17
CREDIT,525.0,UPI-Tanaia Ghosh-3089412372@YBL-SBIN8693836-274591788655-,5576.48,2022-02-17T09:07:58+05:30,,OTHER,,2022-02-17
CREDIT,525.0,UPI-AYAN SHEIKH-6103873655@YBL-SBIN8702397-635473271063-P,6101.48,2022-02-17T09:14:56+05:30,,OTHER,,2022-02-17
CREDIT,525.0,UPI-Shalene Lal-KAAN258@YBL-HDFC4027294-8149761973,6626.48,2022-02-17T09:19:11+05:30,,OTHER,,2022-02-17
CREDIT,525.0,UPI-Tulsi Sharma-2226465404@YBL-HDFC0641843-41816271890,7151.48,2022-02-17T09:23:50+05:30,,OTHER,,2022-02-17
CREDIT,525.0,UPI-RANVEER SINGH-4557223610@YBL-SBIN5833235-961865705900-PAYM,7676.48,2022-02-17T09:43:55+05:30,,OTHER,,2022-02-17
CREDIT,525.0,UPI-DEEPIKA PADUKON-8062170632@IBL-KKBK1964150-65718330,8201.48,2022-02-17T09:50:29+05:30,,OTHER,,2022-02-17
CREDIT,525.0,UPI-Shalene Shaikh-5145721987@YBL-SBIN2175925-38633324,8726.48,2022-02-17T09:52:21+05:30,,OTHER,,2022-02-17
CREDIT,525.0,UPI-Anala Singh-7776235242@YBL-SBIN6329187-41376130,9251.48,2022-02-17T10:04:47+05:30,,OTHER,,2022-02-17
CREDIT,525.0,UPI-Kashvi Khatun-KASHVI19@OKHDFCBANK-HDFC3676860-7,9776.48,2022-02-17T10:15:07+05:30,,OTHER,,2022-02-17
DEBIT,3780.0,UPI-Kaan Kumar-KAAN215@YBL-HDFC1249847-6162553701,5996.48,2022-02-17T13:38:35+05:30,,OTHER,,2022-02-17
CREDIT,105.0,UPI-Amitabh Kumar-KAAN366@YBL-HDFC8686319-0591228984,6101.48,2022-02-17T17:44:48+05:30,,OTHER,,2022-02-17
DEBIT,493.5,UPI-Darsh Sahu-RAZORPAYONLINE@YBL-YESB3YBLUPI-2701,5607.98,2022-02-17T18:20:21+05:30,,OTHER,,2022-02-17
CREDIT,918.75,IMPS-904998011667-Raghav Sah PVT LTD-YESB-XXXXXXXXXXX5676-PLAYERZP,6526.73,2022-02-17T18:51:23+05:30,,OTHER,,2022-02-17
DEBIT,126.0,UPI-Divya Patil-RAZORPAYONLINE@YBL-YESB3YBLUPI-3329,6400.73,2022-02-17T19:31:07+05:30,,OTHER,,2022-02-17
DEBIT,91.35,UPI-DAVID PATEL-9961222104@YBL-HDFC6082359-21230730,6309.38,2022-02-17T20:12:11+05:30,,OTHER,,2022-02-17
DEBIT,561.75,UPI-Ishani Lal-RAZORPAYONLINE@YBL-YESB7YBLUPI-6372,5747.63,2022-02-18T04:08:16+05:30,,OTHER,,2022-02-18
DEBIT,406.35,UPI-DREAM11-DREAM11ONLINE@YBL-YESB0YBLUPI-200818413557-PAYME,5341.28,2022-02-18T07:12:02+05:30,,OTHER,,2022-02-18
DEBIT,131.25,UPI-DREAM11-DREAM11ONLINE@YBL-YESB0YBLUPI-200825106750-PAYME,5210.03,2022-02-18T09:33:55+05:30,,OTHER,,2022-02-18
CREDIT,1470.0,IMPS-392691821371-FIDUCIARY BILLING SO-YESB-XXXXXXXXXXX3142-,6680.03,2022-02-18T13:33:29+05:30,,OTHER,,2022-02-18
CREDIT,1123.5,IMPS-217833770832-Tanaia Roy PVT LTD-YESB-XXXXXXXXXXX5551-PLAYERZP,7803.53,2022-02-18T20:31:15+05:30,,OTHER,,2022-02-18
DEBIT,126.0,UPI-Yanisha Mishra-RAZORPAYONLINE@YBL-YESB0YBLUPI-9007,7677.53,2022-02-18T20:56:18+05:30,,OTHER,,2022-02-18
DEBIT,477.75,UPI-Shalena Singh-RAZORPAYONLINE@YBL-YESB7YBLUPI-7909,7199.78,2022-02-18T21:05:51+05:30,,OTHER,,2022-02-18
DEBIT,126.0,UPI-Raghav Sharma-RAZORPAYONLINE@YBL-YESB4YBLUPI-8648,7073.78,2022-02-18T21:06:25+05:30,,OTHER,,2022-02-18
DEBIT,61.95,UPI-BHARTI AIRTEL LIMITE-AIRTELPREDIRECT5@YBL-YESB7YBLUPI-57,7011.83,2022-02-19T07:14:50+05:30,,OTHER,,2022-02-19
CREDIT,161.7,UPI-AYAN SHEIKH-5016722399@YBL-SBIN3993422-426833269248-P,7173.53,2022-02-19T12:51:39+05:30,,OTHER,,2022-02-19
CREDIT,162.75,UPI-Drisana Sahu-0732872351@YBL-SBIN9809953-26617561,7336.28,2022-02-19T15:03:24+05:30,,OTHER,,2022-02-19
CREDIT,161.7,UPI-Avan Ray-8000526547@YBL-HDFC5289485-90232532714,7497.98,2022-02-19T15:25:36+05:30,,OTHER,,2022-02-19
DEBIT,316.05,UPI-Sudhir Thakur-EURONET@YBL-YESB2YBLUPI-934048773723-PAYMENT FRO,7181.93,2022-02-20T04:02:35+05:30,,OTHER,,2022-02-20
CREDIT,161.7,UPI-Shaila Ram-7795663323@YBL-SBIN7906958-67314872799,7343.63,2022-02-20T06:10:29+05:30,,OTHER,,2022-02-20
CREDIT,6300.0,UPI-KIRAN BHANUSHALI-7108340606@YBL-SBIN0842299-426650192571,13643.63,2022-02-20T06:27:14+05:30,,OTHER,,2022-02-20
CREDIT,161.7,UPI-NIKOLA KOVAC-NIKO.AJ@OKAXIS-SBIN9729535-46613554229,13805.33,2022-02-20T06:44:43+05:30,,OTHER,,2022-02-20
DEBIT,15540.0,IB BILLPAY DR-HDFCYA-738506XXXXXX1503,-1734.67,2022-02-20T07:03:43+05:30,,OTHER,,2022-02-20
CREDIT,161.7,UPI-RAHI.SHAH-5052202699@YBL-BARB0KOSAMD-186434312,-1572.97,2022-02-20T08:08:22+05:30,,OTHER,,2022-02-20
CREDIT,161.7,UPI-Damayanti Lal-1137536608@YBL-HDFC2447193-72345408456,-1411.27,2022-02-20T08:32:16+05:30,,OTHER,,2022-02-20
CREDIT,161.7,UPI-Amitabh Begam-0816717622@YBL-SBIN4366691-778565743990-,-1249.57,2022-02-20T09:15:36+05:30,,OTHER,,2022-02-20
CREDIT,161.7,UPI-DEEPIKA PADUKON-8906828404@IBL-KKBK3814379-09797008,-1087.87,2022-02-20T09:17:33+05:30,,OTHER,,2022-02-20
CREDIT,161.7,UPI-Bharat Nayak-2872294135@IBL-SBIN9937743-411428530146-PA,-926.17,2022-02-20T09:46:09+05:30,,OTHER,,2022-02-20
CREDIT,161.7,UPI-Shaila Sharma-SHAILA@YBL-ICIC0012521-15293042759,-764.47,2022-02-20T10:40:51+05:30,,OTHER,,2022-02-20
CREDIT,1102.5,IMPS-230156580940-FIDUCIARY BILLING SO-YESB-XXXXXXXXXXX4981-,338.03,2022-02-20T12:43:34+05:30,,OTHER,,2022-02-20
DEBIT,15.75,UPI-Raghav Rathod-RAZORPAYONLINE@YBL-YESB0YBLUPI-6204,322.28,2022-02-20T12:55:14+05:30,,OTHER,,2022-02-20
DEBIT,126.0,UPI-Aja Paswan-RAZORPAYONLINE@YBL-YESB4YBLUPI-9587,196.28,2022-02-20T13:03:17+05:30,,OTHER,,2022-02-20
DEBIT,126.0,UPI-Mahika Mandal-RAZORPAYONLINE@YBL-YESB3YBLUPI-2228,70.28,2022-02-20T13:13:09+05:30,,OTHER,,2022-02-20
DEBIT,603.75,UPI-Darsh Mishra-RAZORPAYONLINE@YBL-YESB0YBLUPI-5199,-533.47,2022-02-20T13:26:39+05:30,,OTHER,,2022-02-20
DEBIT,126.0,UPI-Kimaya Jadhav-RAZORPAYONLINE@YBL-YESB0YBLUPI-7852,-659.47,2022-02-20T14:24:39+05:30,,OTHER,,2022-02-20
DEBIT,84.0,UPI-Neha Begam-RAZORPAYONLINE@YBL-YESB3YBLUPI-6097,-743.47,2022-02-20T19:11:12+05:30,,OTHER,,2022-02-20
DEBIT,126.0,UPI-Kavi Khatun-RAZORPAYONLINE@YBL-YESB2YBLUPI-5110,-869.47,2022-02-20T19:19:46+05:30,,OTHER,,2022-02-20
DEBIT,126.0,UPI-Sona Mahato-RAZORPAYONLINE@YBL-YESB2YBLUPI-1372,-995.47,2022-02-21T11:42:56+05:30,,OTHER,,2022-02-21
DEBIT,126.0,UPI-Kaan Ghosh-RAZORPAYONLINE@YBL-YESB1YBLUPI-9179,-1121.47,2022-02-21T18:20:34+05:30,,OTHER,,2022-02-21
DEBIT,126.0,UPI-Damayanti Lal-RAZORPAYONLINE@YBL-YESB4YBLUPI-6765,-1247.47,2022-02-21T18:32:11+05:30,,OTHER,,2022-02-21
DEBIT,157.5,UPI-Yanisha Khatoon-RAZORPAYONLINE@YBL-YESB1YBLUPI-5709,-1404.97,2022-02-21T19:23:42+05:30,,OTHER,,2022-02-21
DEBIT,63.0,UPI-KAMALKISHOREMAHESHWA-Q578581669@YBL-YESB2YBLUPI-87286328,-1467.97,2022-02-22T04:47:35+05:30,,OTHER,,2022-02-22
CREDIT,161.7,UPI-RANVEER SINGH-5150385280@YBL-SBIN1437379-536009881891-PAYM,-1306.27,2022-02-22T11:04:07+05:30,,OTHER,,2022-02-22
DEBIT,126.0,UPI-Kavi Sahu-RAZORPAYONLINE@YBL-YESB5YBLUPI-5636,-1432.27,2022-02-23T12:45:08+05:30,,OTHER,,2022-02-23
DEBIT,84.0,UPI-Akshay Sharma-RAZORPAYONLINE@YBL-YESB9YBLUPI-7126,-1516.27,2022-02-23T13:50:47+05:30,,OTHER,,2022-02-23
DEBIT,126.0,UPI-Prasad Ma-RAZORPAYONLINE@YBL-YESB3YBLUPI-9990,-1642.27,2022-02-23T13:57:49+05:30,,OTHER,,2022-02-23
DEBIT,126.0,UPI-PLAYERZPOT MEDIA PVT-PLAYERZPOTMEDIA.RZP@YESBANK-YESB417,-1768.27,2022-02-23T14:15:08+05:30,,OTHER,,2022-02-23
DEBIT,53.55,UPI-METHAN-PAYTM-43143286@PAYTM-PYTM4469176-751947091818-UPI,-1821.82,2022-02-23T14:33:46+05:30,,OTHER,,2022-02-23
CREDIT,2100.0,UPI-Raghav Lal-2033957900@YBL-SBIN9804702-3068094309,278.18,2022-02-25T09:45:54+05:30,,OTHER,,2022-02-25
DEBIT,2100.0,UPI-Amitabh Sekh-KAAN601@YBL-HDFC0683517-4277645967,-1821.82,2022-02-25T12:18:32+05:30,,OTHER,,2022-02-25
CREDIT,551.25,IMPS-345333658736-FIDUCIARY BILLING SO-YESB-XXXXXXXXXXX2333-,-1270.57,2022-03-01T10:11:31+05:30,,OTHER,,2022-03-01
CREDIT,630.0,UPI-JENISH VEKARIYA-0845174287@YBL-HDFC8969894-979911353967,-640.57,2022-03-01T10:11:48+05:30,,OTHER,,2022-03-01
DEBIT,787.5,UPI-Tanaia Begum-6201266521@YBL-HDFC4137603-11924630,-1428.07,2022-03-01T10:17:16+05:30,,OTHER,,2022-03-01
CREDIT,12307.05,UPI-JENISH VEKARIYA-6662770092@YBL-HDFC2162078-808832756584,10878.98,2022-03-01T10:19:51+05:30,,OTHER,,2022-03-01
DEBIT,12307.05,UPI-Damayanti Shaikh-8175571451@YBL-HDFC6026147-20485179,-1428.07,2022-03-01T10:21:34+05:30,,OTHER,,2022-03-01
DEBIT,126.0,UPI-Ishani Bibi-RAZORPAYONLINE@YBL-YESB1YBLUPI-0021,-1554.07,2022-03-01T12:42:07+05:30,,OTHER,,2022-03-01
CREDIT,498.75,IMPS-631325648655-Ambar Khatoon PVT LTD-YESB-XXXXXXXXXXX0805-PLAYERZP,-1055.32,2022-03-01T14:26:48+05:30,,OTHER,,2022-03-01
DEBIT,126.0,UPI-Drisana Rathod-RAZORPAYONLINE@YBL-YESB5YBLUPI-2349,-1181.32,2022-03-01T16:12:50+05:30,,OTHER,,2022-03-01
DEBIT,126.0,UPI-Aja Sah-RAZORPAYONLINE@YBL-YESB3YBLUPI-7009,-1307.32,2022-03-01T16:27:10+05:30,,OTHER,,2022-03-01
DEBIT,126.0,UPI-Shylah Patel-RAZORPAYONLINE@YBL-YESB4YBLUPI-6412,-1433.32,2022-03-02T03:32:49+05:30,,OTHER,,2022-03-02
DEBIT,42.0,UPI-Salina Mandal-RAZORPAYONLINE@YBL-YESB1YBLUPI-8557,-1475.32,2022-03-02T03:57:09+05:30,,OTHER,,2022-03-02
CREDIT,630.0,IMPS-270110536255-FIDUCIARY BILLING SO-YESB-XXXXXXXXXXX5014-,-845.32,2022-03-02T13:35:15+05:30,,OTHER,,2022-03-02
CREDIT,1123.5,IMPS-286582242089-Ashwin Kaur PVT LTD-YESB-XXXXXXXXXXX5478-PLAYERZP,278.18,2022-03-02T15:32:02+05:30,,OTHER,,2022-03-02
DEBIT,126.0,UPI-Kimaya Sharma-RAZORPAYONLINE@YBL-YESB5YBLUPI-8038,152.18,2022-03-02T18:37:33+05:30,,OTHER,,2022-03-02
DEBIT,126.0,UPI-Aditi Patil-RAZORPAYONLINE@YBL-YESB9YBLUPI-8957,26.18,2022-03-02T18:46:39+05:30,,OTHER,,2022-03-02
DEBIT,42.0,UPI-Sitara Ghosh-RAZORPAYONLINE@YBL-YESB1YBLUPI-8879,-15.82,2022-03-02T19:02:30+05:30,,OTHER,,2022-03-02
DEBIT,84.0,UPI-PLAYERZPOT MEDIA PVT-PLAYERZPOTMEDIA.RZP@YESBANK-YESB743,-99.82,2022-03-02T19:43:19+05:30,,OTHER,,2022-03-02
DEBIT,84.0,UPI-Kavi Paswan-RAZORPAYONLINE@YBL-YESB8YBLUPI-3042,-183.82,2022-03-03T03:26:32+05:30,,OTHER,,2022-03-03
DEBIT,211.05,UPI-Kashvi Ansari-RSANGADA1383@OKSBI-SBIN3190639-9836,-394.87,2022-03-03T12:04:12+05:30,,OTHER,,2022-03-03
CREDIT,52.5,IMPS-986000639428-FIDUCIARY BILLING SO-YESB-XXXXXXXXXXX2670-,-342.37,2022-03-03T16:38:38+05:30,,OTHER,,2022-03-03
CREDIT,393.75,IMPS-981381958023-FIDUCIARY BILLING SO-YESB-XXXXXXXXXXX0330-,51.38,2022-03-03T16:40:39+05:30,,OTHER,,2022-03-03
DEBIT,126.0,UPI-Amata Thakur-RAZORPAYONLINE@YBL-YESB4YBLUPI-3690,-74.62,2022-03-03T16:57:23+05:30,,OTHER,,2022-03-03
DEBIT,126.0,UPI-Janitra Thakur-RAZORPAYONLINE@YBL-YESB7YBLUPI-7501,-200.62,2022-03-03T17:05:32+05:30,,OTHER,,2022-03-03
DEBIT,126.0,UPI-Kavi Nayak-RAZORPAYONLINE@YBL-YESB2YBLUPI-0606,-326.62,2022-03-03T18:23:14+05:30,,OTHER,,2022-03-03
CREDIT,582.75,IMPS-623885943523-Sitara Patel PVT LTD-YESB-XXXXXXXXXXX3525-PLAYERZP,256.13,2022-03-03T20:25:08+05:30,,OTHER,,2022-03-03
CREDIT,113.4,IMPS-581478035240-FIDUCIARY BILLING SO-INDB-XXXXXXXX9160-CT2,369.53,2022-03-03T20:26:07+05:30,,OTHER,,2022-03-03
DEBIT,126.0,UPI-Farid Behera-RAZORPAYONLINE@YBL-YESB4YBLUPI-2214,243.53,2022-03-04T03:55:32+05:30,,OTHER,,2022-03-04
DEBIT,42.0,UPI-Kaan Behera-RAZORPAYONLINE@YBL-YESB9YBLUPI-0496,201.53,2022-03-04T04:15:08+05:30,,OTHER,,2022-03-04
DEBIT,126.0,UPI-Shalene Roy-RAZORPAYONLINE@YBL-YESB5YBLUPI-3529,75.53,2022-03-04T04:25:15+05:30,,OTHER,,2022-03-04
DEBIT,126.0,UPI-Mahika Sarkar-RAZORPAYONLINE@YBL-YESB6YBLUPI-7197,-50.47,2022-03-04T04:38:08+05:30,,OTHER,,2022-03-04
DEBIT,84.0,UPI-Bharat Patil-RAZORPAYONLINE@YBL-YESB8YBLUPI-0280,-134.47,2022-03-04T05:16:56+05:30,,OTHER,,2022-03-04
DEBIT,126.0,UPI-PLAYERZPOT MEDIA PVT-PLAYERZPOTMEDIA.RZP@YESBANK-YESB239,-260.47,2022-03-04T10:55:39+05:30,,OTHER,,2022-03-04
DEBIT,42.0,UPI-PLAYERZPOT MEDIA PVT-PLAYERZPOTMEDIA.RZP@YESBANK-YESB891,-302.47,2022-03-04T13:03:30+05:30,,OTHER,,2022-03-04
DEBIT,26.25,UPI-PLAYERZPOT MEDIA PVT-PLAYERZPOTMEDIA.RZP@YESBANK-YESB905,-328.72,2022-03-04T18:54:04+05:30,,OTHER,,2022-03-04
DEBIT,126.0,UPI-PLAYERZPOT MEDIA PVT-PLAYERZPOTMEDIA.RZP@YESBANK-YESB301,-454.72,2022-03-04T19:19:09+05:30,,OTHER,,2022-03-04
DEBIT,113.4,UPI-DAVID PATEL-4346779606@YBL-HDFC4602199-08418637,-568.12,2022-03-04T19:52:50+05:30,,OTHER,,2022-03-04
DEBIT,126.0,UPI-Divya Jadhav-RAZORPAYONLINE@YBL-YESB0YBLUPI-6754,-694.12,2022-03-05T05:52:42+05:30,,OTHER,,2022-03-05
DEBIT,42.0,UPI-Anala Kumari-RAZORPAYONLINE@YBL-YESB8YBLUPI-0186,-736.12,2022-03-05T06:10:17+05:30,,OTHER,,2022-03-05
DEBIT,253.05,UPI-BHARTI AIRTEL LIMITE-AIRTELPREDIRECT5@YBL-YESB0YBLUPI-50,-989.17,2022-03-06T13:01:04+05:30,,OTHER,,2022-03-06
DEBIT,2.62,UPI-Mayur Kaur-RAZORPAYONLINE@YBL-YESB8YBLUPI-3269,-991.79,2022-03-07T18:22:53+05:30,,OTHER,,2022-03-07
DEBIT,126.0,UPI-Shaila Yadav-RAZORPAYONLINE@YBL-YESB4YBLUPI-1873,-1117.79,2022-03-07T19:44:26+05:30,,OTHER,,2022-03-07
CREDIT,1081.5,IMPS-359199205750-Anila Pal PVT LTD-YESB-XXXXXXXXXXX0726-PLAYERZP,-36.29,2022-03-08T01:53:48+05:30,,OTHER,,2022-03-08
DEBIT,126.0,UPI-Varun Chand-RAZORPAYONLINE@YBL-YESB6YBLUPI-2186,-162.29,2022-03-08T05:19:54+05:30,,OTHER,,2022-03-08
DEBIT,110.25,UPI-Shalene Yadav-RAZORPAYONLINE@YBL-YESB9YBLUPI-7695,-272.54,2022-03-08T09:33:30+05:30,,OTHER,,2022-03-08
DEBIT,126.0,UPI-Mayur Kaur-RAZORPAYONLINE@YBL-YESB9YBLUPI-5368,-398.54,2022-03-08T11:51:03+05:30,,OTHER,,2022-03-08
DEBIT,1050.0,UPI-KIRAN BHANUSHALI-9258721336@YBL-SBIN4086982-023458699129,-1448.54,2022-03-08T13:04:21+05:30,,OTHER,,2022-03-08
DEBIT,126.0,UPI-Raghav Behera-RAZORPAYONLINE@YBL-YESB2YBLUPI-4742,-1574.54,2022-03-08T14:36:09+05:30,,OTHER,,2022-03-08
DEBIT,42.0,UPI-Sahil Sekh-RAZORPAYONLINE@YBL-YESB1YBLUPI-0377,-1616.54,2022-03-08T15:05:39+05:30,,OTHER,,2022-03-08
DEBIT,126.0,UPI-Kashvi Ram-RAZORPAYONLINE@YBL-YESB8YBLUPI-4784,-1742.54,2022-03-08T15:25:46+05:30,,OTHER,,2022-03-08
DEBIT,52.5,UPI-Damayanti Begam-RAZORPAYONLINE@YBL-YESB1YBLUPI-7493,-1795.04,2022-03-09T04:49:40+05:30,,OTHER,,2022-03-09
CREDIT,540.75,IMPS-034622430281-Shaila Das PVT LTD-YESB-XXXXXXXXXXX8666-PLAYERZP,-1254.29,2022-03-09T06:54:31+05:30,,OTHER,,2022-03-09
DEBIT,126.0,UPI-Damayanti Jadhav-RAZORPAYONLINE@YBL-YESB7YBLUPI-5244,-1380.29,2022-03-09T15:49:51+05:30,,OTHER,,2022-03-09
DEBIT,126.0,UPI-Shaleena Sahu-RAZORPAYONLINE@YBL-YESB0YBLUPI-1761,-1506.29,2022-03-09T15:58:55+05:30,,OTHER,,2022-03-09
DEBIT,126.0,UPI-Manu Behera-RAZORPAYONLINE@YBL-YESB5YBLUPI-1864,-1632.29,2022-03-09T16:07:57+05:30,,OTHER,,2022-03-09
DEBIT,84.0,UPI-Tej Thakur-RAZORPAYONLINE@YBL-YESB9YBLUPI-6854,-1716.29,2022-03-09T18:29:26+05:30,,OTHER,,2022-03-09
DEBIT,42.0,UPI-Chander Singh-RAZORPAYONLINE@YBL-YESB6YBLUPI-3760,-1758.29,2022-03-09T19:47:03+05:30,,OTHER,,2022-03-09
DEBIT,42.0,UPI-Shalena Patil-RAZORPAYONLINE@YBL-YESB1YBLUPI-9816,-1800.29,2022-03-09T20:06:52+05:30,,OTHER,,2022-03-09
CREDIT,105.0,UPI-RANVEER SINGH-SINGHPIRIMID@OKSBI-SBIN4871627-2581602408,-1695.29,2022-03-10T09:27:25+05:30,,OTHER,,2022-03-10
CREDIT,525.0,UPI-Charu Bibi-9652179414@YBL-HDFC5533976-748003389184-PAY,-1170.29,2022-03-10T12:43:04+05:30,,OTHER,,2022-03-10
DEBIT,126.0,UPI-Varun Sarkar-RAZORPAYONLINE@YBL-YESB3YBLUPI-3689,-1296.29,2022-03-10T14:20:32+05:30,,OTHER,,2022-03-10
DEBIT,42.0,UPI-Tulsi Ma-RAZORPAYONLINE@YBL-YESB1YBLUPI-1931,-1338.29,2022-03-10T15:00:51+05:30,,OTHER,,2022-03-10
CREDIT,288.75,IMPS-930708606082-Kashvi Bibi PVT LTD-YESB-XXXXXXXXXXX1605-PLAYERZP,-1049.54,2022-03-10T15:22:41+05:30,,OTHER,,2022-03-10
DEBIT,126.0,UPI-Sitara Mahto-RAZORPAYONLINE@YBL-YESB1YBLUPI-3625,-1175.54,2022-03-10T16:00:30+05:30,,OTHER,,2022-03-10
DEBIT,42.0,UPI-Reva Khatoon-RAZORPAYONLINE@YBL-YESB3YBLUPI-2215,-1217.54,2022-03-10T16:43:30+05:30,,OTHER,,2022-03-10
DEBIT,42.0,UPI-Tej Mishra-RAZORPAYONLINE@YBL-YESB0YBLUPI-5351,-1259.54,2022-03-11T02:50:12+05:30,,OTHER,,2022-03-11
DEBIT,42.0,UPI-Reva Devi-RAZORPAYONLINE@YBL-YESB1YBLUPI-0729,-1301.54,2022-03-11T03:09:44+05:30,,OTHER,,2022-03-11
DEBIT,115.5,UPI-Avan Kumar-RAZORPAYONLINE@YBL-YESB7YBLUPI-5026,-1417.04,2022-03-11T12:51:42+05:30,,OTHER,,2022-03-11
DEBIT,42.0,UPI-Tej Devi-RAZORPAYONLINE@YBL-YESB4YBLUPI-9291,-1459.04,2022-03-11T14:14:01+05:30,,OTHER,,2022-03-11
CREDIT,52288.95,NEFT CR-BOFA5ND1305-PIRIMID FINTECH INDIA PVT LTD-KEVAL PUROHIT RAI-809,50829.91,2022-03-13T08:26:30+05:30,,OTHER,,2022-03-13
DEBIT,4364.85,UPI-Salina Kumari-KAAN855@YBL-HDFC1772313-0027508855,46465.06,2022-03-13T10:02:28+05:30,,OTHER,,2022-03-13
DEBIT,6300.0,UPI-Anila Sharma-ANU12@OKSBI-SBIN7740719-8039,40165.06,2022-03-13T10:08:35+05:30,,OTHER,,2022-03-13
DEBIT,5250.0,UPI-RAM RAHIM-6931135163@YBL-SBIN1442996-19690427,34915.06,2022-03-13T10:18:29+05:30,,OTHER,,2022-03-13
DEBIT,5250.0,UPI-Amata Gupta-AMATA6@AXL-SBIN0499342-1655,29665.06,2022-03-13T10:18:53+05:30,,OTHER,,2022-03-13
DEBIT,3720.58,IB BILLPAY DR-HDFCCC-757250XXXXXX5968,25944.48,2022-03-13T11:39:59+05:30,,OTHER,,2022-03-13
DEBIT,3150.0,UPI-KIRAN BHANUSHALI-2767092084@YBL-SBIN5370181-448398385625,22794.48,2022-03-13T11:53:43+05:30,,OTHER,,2022-03-13
CREDIT,105000.0,INSTA JUMBO LOAN8199160981679817222,127794.48,2022-03-13T11:57:54+05:30,,OTHER,,2022-03-13
DEBIT,33400.5,IB BILLPAY DR-HDFCYA-262958XXXXXX4119,94393.98,2022-03-13T11:58:29+05:30,,OTHER,,2022-03-13
DEBIT,10500.0,UPI-DARSHAN SHARMA-SHARMA3585@OKICICI-ICIC8914657-553747938,83893.98,2022-03-13T12:16:27+05:30,,OTHER,,2022-03-13
DEBIT,15750.0,UPI-RUTVIK SINGH-RUTVIK.SINGH973@OKICICI-ICIC726,68143.98,2022-03-13T12:17:53+05:30,,OTHER,,2022-03-13
DEBIT,89.25,UPI-Chander Paramar-RAZORPAYONLINE@YBL-YESB3YBLUPI-7136,68054.73,2022-03-13T12:48:40+05:30,,OTHER,,2022-03-13
DEBIT,126.0,UPI-Mayur Nayak-RAZORPAYONLINE@YBL-YESB1YBLUPI-0762,67928.73,2022-03-13T14:36:51+05:30,,OTHER,,2022-03-13
CREDIT,540.75,IMPS-740145214567-Shaila Ma PVT LTD-YESB-XXXXXXXXXXX2770-PLAYERZP,68469.48,2022-03-13T16:14:20+05:30,,OTHER,,2022-03-13
DEBIT,1365.0,UPI-KIRAN BHANUSHALI-9812392728@YBL-SBIN8829398-685151873463,67104.48,2022-03-14T06:15:25+05:30,,OTHER,,2022-03-14
DEBIT,126.0,UPI-Aadhira Khan-RAZORPAYONLINE@YBL-YESB7YBLUPI-3817,66978.48,2022-03-14T10:13:53+05:30,,OTHER,,2022-03-14
DEBIT,126.0,UPI-Amitabh Ali-RAZORPAYONLINE@YBL-YESB2YBLUPI-3252,66852.48,2022-03-14T10:25:34+05:30,,OTHER,,2022-03-14
DEBIT,126.0,UPI-Prasad Nayak-RAZORPAYONLINE@YBL-YESB4YBLUPI-7503,66726.48,2022-03-14T11:18:26+05:30,,OTHER,,2022-03-14
DEBIT,603.75,UPI-Artha Khatun-RAZORPAYONLINE@YBL-YESB4YBLUPI-0133,66122.73,2022-03-14T11:25:53+05:30,,OTHER,,2022-03-14
CREDIT,5250.0,UPI-RUTVIK SINGH-RUTVIK.SINGH197@OKICICI-ICIC662,71372.73,2022-03-15T10:55:27+05:30,,OTHER,,2022-03-15
DEBIT,199.5,UPI-HATHIYANI HIREN MAVJ-Q29495740@YBL-PYTM9441823-694912154,71173.23,2022-03-15T13:45:13+05:30,,OTHER,,2022-03-15
DEBIT,1.05,UPI-KAREEM KUMAR-4371305657@AXL-HDFC5188986-044967708090-W,71172.18,2022-03-15T14:24:38+05:30,,OTHER,,2022-03-15
DEBIT,6825.0,UPI-KAREEM KUMAR-2901769267@YBL-HDFC5430023-579797680301-P,64347.18,2022-03-15T14:26:56+05:30,,OTHER,,2022-03-15
DEBIT,4832.46,POS 128123XXXXXX6370 DMART BHARUCH DM,59514.72,2022-03-15T15:32:47+05:30,,OTHER,,2022-03-15
DEBIT,525.0,UPI-Shalena Pal-68176476@IBL-UTIB4103511-029368321633-,58989.72,2022-03-15T17:05:24+05:30,,OTHER,,2022-03-15
DEBIT,126.0,UPI-Darsh Kumar-RAZORPAYONLINE@YBL-YESB6YBLUPI-1805,58863.72,2022-03-16T01:31:06+05:30,,OTHER,,2022-03-16
DEBIT,84.0,UPI-Farid Sah-RAZORPAYONLINE@YBL-YESB9YBLUPI-6538,58779.72,2022-03-16T02:26:37+05:30,,OTHER,,2022-03-16
DEBIT,126.0,UPI-Neha Paramar-RAZORPAYONLINE@YBL-YESB4YBLUPI-8701,58653.72,2022-03-16T11:06:45+05:30,,OTHER,,2022-03-16
DEBIT,5250.0,UPI-KIRAN BHANUSHALI-4135917813@YBL-SBIN8315152-403946985847,53403.72,2022-03-17T04:52:36+05:30,,OTHER,,2022-03-17
DEBIT,10500.0,UPI-AYAN SHEIKH-2784631437@YBL-SBIN8935653-267247235893-P,42903.72,2022-03-17T11:28:09+05:30,,OTHER,,2022-03-17
DEBIT,105.0,UPI-AYAN SHEIKH-1838478304@YBL-SBIN6127550-848439621761-P,42798.72,2022-03-17T12:37:39+05:30,,OTHER,,2022-03-17
DEBIT,126.0,UPI-Shaila Das-RAZORPAYONLINE@YBL-YESB4YBLUPI-8112,42672.72,2022-03-18T04:22:04+05:30,,OTHER,,2022-03-18
DEBIT,2100.0,UPI-KIRAN BHANUSHALI-6849165804@YBL-SBIN3207310-497574161604,40572.72,2022-03-19T03:12:55+05:30,,OTHER,,2022-03-19
DEBIT,136.5,UPI-MEHUL KANABAR-PAYTMQR639567089684HUC8WQ3CUTPX@PAYTM-PYTM,40436.22,2022-03-19T13:31:33+05:30,,OTHER,,2022-03-19
DEBIT,1271.55,ACH D- LIC OF INDIA-1406402914922,39164.67,2022-03-20T05:14:24+05:30,,OTHER,,2022-03-20
DEBIT,15445.5,EMI 1749266   CHQ S96586574621 82898056725,23719.17,2022-03-20T05:45:44+05:30,,OTHER,,2022-03-20
DEBIT,505.05,UPI-Marjane Thakur-EURONET@YBL-YESB5YBLUPI-061387807675-PAYMENT FRO,23214.12,2022-03-20T09:43:41+05:30,,OTHER,,2022-03-20
DEBIT,126.0,UPI-Kimaya Mondal-RAZORPAYONLINE@YBL-YESB9YBLUPI-9200,23088.12,2022-03-20T11:19:05+05:30,,OTHER,,2022-03-20
DEBIT,126.0,UPI-Akshay Sekh-RAZORPAYONLINE@YBL-YESB2YBLUPI-1023,22962.12,2022-03-20T11:30:36+05:30,,OTHER,,2022-03-20
DEBIT,51.45,UPI-ASHIRWAD COLDRINKS-Q623057227@YBL-YESB4YBLUPI-6023454309,22910.67,2022-03-21T10:31:36+05:30,,OTHER,,2022-03-21
DEBIT,2100.0,UPI-DEEPIKA PADUKON-2230837637@IBL-KKBK7411652-38005599,20810.67,2022-03-22T12:31:53+05:30,,OTHER,,2022-03-22
DEBIT,78.75,UPI-AYAN SHEIKH-5842179159@YBL-SBIN5136948-115939786423-P,20731.92,2022-03-23T13:00:46+05:30,,OTHER,,2022-03-23
CREDIT,1575.0,UPI-JENISH VEKARIYA-1371306173@YBL-HDFC0318784-965905255095,22306.92,2022-03-24T05:03:40+05:30,,OTHER,,2022-03-24
DEBIT,1575.0,UPI-RANVEER SINGH-8794513321@YBL-SBIN2129605-556116584519-PAYM,20731.92,2022-03-24T05:13:04+05:30,,OTHER,,2022-03-24
DEBIT,177.69,IV2PZDPZ3NJYEP/RAZPHYPERPUREZOMATO,20554.23,2022-03-25T14:02:38+05:30,,OTHER,,2022-03-25
DEBIT,157.5,UPI-JAY BHAWANI SWEETS-BHARATPE.8428238811@FBPE-FDRL3385225-,20396.73,2022-03-25T16:21:39+05:30,,OTHER,,2022-03-25
DEBIT,42.0,UPI-NEW JANSHAKTI DUDH D-PAYTMQR7255618510533GJA9EV97NUM@PAY,20354.73,2022-03-25T16:31:51+05:30,,OTHER,,2022-03-25
DEBIT,105.0,UPI-DHAVAL THAKORBHAI LI-PAYTMQR6675179684690HJU9LHWP383@PAY,20249.73,2022-03-26T06:28:03+05:30,,OTHER,,2022-03-26
DEBIT,147.0,UPI-ROHIT JAGDISHBHAI CH-PAYTMQR323448647054EUHULDPWKI76@PAY,20102.73,2022-03-26T12:25:17+05:30,,OTHER,,2022-03-26
DEBIT,6300.0,UPI-KIRAN BHANUSHALI-4280723726@YBL-SBIN4904665-447556529435,13802.73,2022-03-28T04:29:05+05:30,,OTHER,,2022-03-28
DEBIT,25.46,UPI-ZOMATO-ZOMATO@HDFCBANK-HDFC2843733-403724979677-ZOMATOON,13777.27,2022-03-28T14:38:48+05:30,,OTHER,,2022-03-28
DEBIT,105.0,UPI-BHARTI AIRTEL LIMITE-AIRTELPREDIRECT7@YBL-YESB7YBLUPI-09,13672.27,2022-03-29T11:10:48+05:30,,OTHER,,2022-03-29
DEBIT,253.05,UPI-BHARTI AIRTEL LIMITE-AIRTELPREDIRECT5@YBL-YESB0YBLUPI-80,13419.22,2022-03-29T11:38:46+05:30,,OTHER,,2022-03-29
DEBIT,26.25,UPI-Arti Singh-EURONET@YBL-YESB0YBLUPI-035303688578-PAYMENT FRO,13392.97,2022-03-29T13:21:47+05:30,,OTHER,,2022-03-29
DEBIT,120.75,UPI-PLAYERZPOT MEDIA PVT-PLAYERZPOT@PAYTM-PYTM6387370-896484,13272.22,2022-03-29T13:52:58+05:30,,OTHER,,2022-03-29
CREDIT,414.75,IMPS-400367341178-Tej Rani PVT LTD-YESB-XXXXXXXXXXX4182-PLAYERZP,13686.97,2022-03-29T14:51:01+05:30,,OTHER,,2022-03-29
DEBIT,590.0,CHQ RETURN CHGS INCL GST 010122-CDT2200207254121,13096.97,2022-03-29T14:56:01+05:30,,OTHER,,2022-03-29
DEBIT,126.0,UPI-PLAYERZPOT MEDIA PVT-PLAYERZPOT@PAYTM-PYTM6077686-302971,12970.97,2022-03-29T15:08:17+05:30,,OTHER,,2022-03-29
DEBIT,84.0,UPI-PLAYERZPOT MEDIA PVT-PLAYERZPOT@PAYTM-PYTM2717818-080578,12886.97,2022-03-30T02:18:04+05:30,,OTHER,,2022-03-30
DEBIT,126.0,UPI-PLAYERZPOT MEDIA PVT-PLAYERZPOT@PAYTM-PYTM6458584-699644,12760.97,2022-03-30T02:26:26+05:30,,OTHER,,2022-03-30
DEBIT,126.0,UPI-PLAYERZPOT MEDIA PVT-PLAYERZPOT@PAYTM-PYTM7523320-989705,12634.97,2022-03-30T02:38:09+05:30,,OTHER,,2022-03-30
DEBIT,1050.0,EAW-496690XXXXXX0104-CPCN1752-BHARUCH,11584.97,2022-03-30T13:06:14+05:30,,OTHER,,2022-03-30
DEBIT,21.0,UPI-SANJU AGARBATTI-GPAY-81202620970@OKBIZAXIS-UTIB8731057-6,11563.97,2022-03-30T13:14:33+05:30,,OTHER,,2022-03-30
DEBIT,701.4,UPI-Avan Gupta-EURONET@YBL-YESB4YBLUPI-410723873988-PAYMENT FRO,10862.57,2022-03-30T15:51:40+05:30,,OTHER,,2022-03-30
DEBIT,42.0,UPI-PLAYERZPOT MEDIA PVT-PLAYERZPOT@PAYTM-PYTM7972096-402381,10820.57,2022-03-31T01:56:34+05:30,,OTHER,,2022-03-31
DEBIT,78.75,UPI-PLAYERZPOT MEDIA PVT-PLAYERZPOT@PAYTM-PYTM3068047-639151,10741.82,2022-04-01T02:12:05+05:30,,OTHER,,2022-04-01
DEBIT,603.75,UPI-PLAYERZPOT MEDIA PVT-PLAYERZPOT@PAYTM-PYTM9739555-747365,10138.07,2022-04-01T02:19:35+05:30,,OTHER,,2022-04-01
CREDIT,1002.75,IMPS-488594715653-Shylah Shaikh PVT LTD-YESB-XXXXXXXXXXX2204-PLAYERZP,11140.82,2022-04-01T02:50:51+05:30,,OTHER,,2022-04-01
DEBIT,61.95,UPI-BHARTI AIRTEL LIMITE-AIRTELPREDIRECT2@YBL-YESB6YBLUPI-80,11078.87,2022-04-01T07:33:48+05:30,,OTHER,,2022-04-01
DEBIT,126.0,UPI-PLAYERZPOT MEDIA PVT-PLAYERZPOT@PAYTM-PYTM1773481-245907,10952.87,2022-04-01T10:20:53+05:30,,OTHER,,2022-04-01
DEBIT,94.5,UPI-Mahika Mandal  -AMZN5941875152@APL-SBIN8278333-3500,10858.37,2022-04-01T12:36:33+05:30,,OTHER,,2022-04-01
DEBIT,126.0,UPI-PLAYERZPOT MEDIA PVT-PLAYERZPOT@PAYTM-PYTM5021256-294676,10732.37,2022-04-01T22:29:52+05:30,,OTHER,,2022-04-01
DEBIT,42.0,UPI-PLAYERZPOT MEDIA PVT-PLAYERZPOT@PAYTM-PYTM6806229-518712,10690.37,2022-04-01T22:43:44+05:30,,OTHER,,2022-04-01
DEBIT,42.0,UPI-PLAYERZPOT MEDIA PVT-PLAYERZPOT@PAYTM-PYTM0970920-328110,10648.37,2022-04-02T05:56:22+05:30,,OTHER,,2022-04-02
DEBIT,42.0,UPI-PLAYERZPOT MEDIA PVT-PLAYERZPOT@PAYTM-PYTM6340849-056170,10606.37,2022-04-02T09:23:43+05:30,,OTHER,,2022-04-02
DEBIT,179.13,UPI-ZOMATO LTD-ZOMATO-ORDER@PAYTM-PYTM8657394-838322884110-Z,10427.24,2022-04-02T14:21:57+05:30,,OTHER,,2022-04-02
DEBIT,126.0,UPI-PLAYERZPOT MEDIA PVT-PLAYERZPOT@PAYTM-PYTM0029620-559662,10301.24,2022-04-03T02:29:29+05:30,,OTHER,,2022-04-03
CREDIT,372.75,IMPS-971098465305-Reva Sarkar PVT LTD-YESB-XXXXXXXXXXX3385-PLAYERZP,10673.99,2022-04-03T02:59:27+05:30,,OTHER,,2022-04-03
DEBIT,526.05,UPI-ASHENFALLOUS-ASHENFALLOUSIPP@YESBANK-YESB1677943-0296007,10147.94,2022-04-03T05:18:31+05:30,,OTHER,,2022-04-03
DEBIT,211.05,UPI-ASHENFALLOUS-ASHENFALLOUSIPP@YESBANK-YESB5177155-7432321,9936.89,2022-04-04T01:21:21+05:30,,OTHER,,2022-04-04
DEBIT,211.05,UPI-ASHENFALLOUS-ASHENFALLOUSIPP@YESBANK-YESB1296041-6477561,9725.84,2022-04-04T01:45:33+05:30,,OTHER,,2022-04-04
DEBIT,53.55,UPI-ASHENFALLOUS-ASHENFALLOUSIPP@YESBANK-YESB1136398-5572693,9672.29,2022-04-04T02:30:05+05:30,,OTHER,,2022-04-04
DEBIT,126.0,UPI-PLAYERZPOT MEDIA PVT-PLAYERZPOT@PAYTM-PYTM0611388-164388,9546.29,2022-04-05T10:38:52+05:30,,OTHER,,2022-04-05
CREDIT,372.75,IMPS-628126807808-Amitabh Ghosh PVT LTD-YESB-XXXXXXXXXXX2343-PLAYERZP,9919.04,2022-04-05T11:10:00+05:30,,OTHER,,2022-04-05
DEBIT,525.0,POS 967899XXXXXX6280 SHELL PETROL STA,9394.04,2022-04-05T11:45:46+05:30,,OTHER,,2022-04-05
DEBIT,3.72,INST-ALERT CHG INC GST OCT-DEC9696-MIR2189513264751,9390.32,2022-04-05T12:04:24+05:30,,OTHER,,2022-04-05
DEBIT,126.0,UPI-PLAYERZPOT MEDIA PVT-PLAYERZPOT@PAYTM-PYTM9743303-085694,9264.32,2022-04-05T12:04:34+05:30,,OTHER,,2022-04-05
DEBIT,5250.0,CHQ PAID-INWARD TRAN-Varun Rathod,4014.32,2022-04-05T12:40:44+05:30,,OTHER,,2022-04-05
DEBIT,57.75,UPI-PLAYERZPOT MEDIA PVT-PLAYERZPOT@PAYTM-PYTM8976162-001736,3956.57,2022-04-06T01:16:35+05:30,,OTHER,,2022-04-06
DEBIT,603.75,UPI-PLAYERZPOT MEDIA PVT-PLAYERZPOT@PAYTM-PYTM0165916-685497,3352.82,2022-04-06T01:23:24+05:30,,OTHER,,2022-04-06
DEBIT,603.75,UPI-PLAYERZPOT MEDIA PVT-PLAYERZPOT@PAYTM-PYTM9854544-501774,2749.07,2022-04-06T02:27:25+05:30,,OTHER,,2022-04-06
DEBIT,603.75,UPI-PLAYERZPOT MEDIA PVT-PLAYERZPOT@PAYTM-PYTM8503744-253110,2145.32,2022-04-06T02:36:09+05:30,,OTHER,,2022-04-06
DEBIT,157.5,UPI-PLAYERZPOT MEDIA PVT-PLAYERZPOT@PAYTM-PYTM8773931-801062,1987.82,2022-04-06T02:56:35+05:30,,OTHER,,2022-04-06
DEBIT,147.0,UPI-THE FARNKIE ZONE-PAYTMQR8318090018701G81VEWNX4TH@PAYTM-P,1840.82,2022-04-06T13:41:06+05:30,,OTHER,,2022-04-06
DEBIT,603.75,UPI-PLAYERZPOT MEDIA PVT-PLAYERZPOT@PAYTM-PYTM8778483-853268,1237.07,2022-04-07T11:38:13+05:30,,OTHER,,2022-04-07
CREDIT,1123.5,IMPS-648683050269-Sudhir Bai PVT LTD-YESB-XXXXXXXXXXX7353-PLAYERZP,2360.57,2022-04-07T14:31:32+05:30,,OTHER,,2022-04-07
DEBIT,126.0,UPI-PLAYERZPOT MEDIA PVT-PLAYERZPOT@PAYTM-PYTM3640958-983342,2234.57,2022-04-07T15:32:29+05:30,,OTHER,,2022-04-07
DEBIT,126.0,UPI-PLAYERZPOT MEDIA PVT-PLAYERZPOT@PAYTM-PYTM1889978-751598,2108.57,2022-04-07T15:45:29+05:30,,OTHER,,2022-04-07
DEBIT,126.0,UPI-PLAYERZPOT MEDIA PVT-PLAYERZPOT@PAYTM-PYTM7492050-998647,1982.57,2022-04-07T15:57:05+05:30,,OTHER,,2022-04-07
DEBIT,126.0,UPI-PLAYERZPOT MEDIA PVT-PLAYERZPOT@PAYTM-PYTM0292233-995330,1856.57,2022-04-07T16:09:07+05:30,,OTHER,,2022-04-07
DEBIT,42.0,UPI-PLAYERZPOT MEDIA PVT-PLAYERZPOT@PAYTM-PYTM4885556-561904,1814.57,2022-04-07T16:26:49+05:30,,OTHER,,2022-04-07
DEBIT,577.5,POS 668250XXXXXX7917 SHELL PETROL STA,1237.07,2022-04-08T13:08:41+05:30,,OTHER,,2022-04-08
DEBIT,157.5,UPI-MR PARESHBHAI GEETES-Q39339632@YBL-CBIN5068662-726698768,1079.57,2022-04-09T03:50:56+05:30,,OTHER,,2022-04-09
DEBIT,315.0,UPI-Akshay Gupta-9655971035@AXL-HDFC3557429-25440523,764.57,2022-04-09T07:40:55+05:30,,OTHER,,2022-04-09
DEBIT,253.05,UPI-BHARTI AIRTEL LIMITE-AIRTELPREDIRECT3@YBL-YESB9YBLUPI-36,511.52,2022-04-09T15:52:42+05:30,,OTHER,,2022-04-09
CREDIT,45182.55,NEFT CR-BOFA3ND5844-PIRIMID FINTECH INDIA PVT LTD-KEVAL PUROHIT RAI-992,45694.07,2022-04-10T08:49:24+05:30,,OTHER,,2022-04-10
DEBIT,8178.17,IB BILLPAY DR-HDFCCC-043265XXXXXX7219,37515.9,2022-04-10T09:55:56+05:30,,OTHER,,2022-04-10
DEBIT,147.0,UPI-Shylah Roy-1631057803@YBL-BKID9157779-05485576,37368.9,2022-04-10T12:52:32+05:30,,OTHER,,2022-04-10
CREDIT,10500.0,UPI-AYAN SHEIKH-1845242538@YBL-SBIN8147235-095278598627-P,47868.9,2022-04-10T13:15:30+05:30,,OTHER,,2022-04-10
DEBIT,1102.5,POS 770472XXXXXX1967 G N ENTERPRISE,46766.4,2022-04-11T05:36:56+05:30,,OTHER,,2022-04-11
DEBIT,127.34,J7JKFUWLWOUHQW/RAZPHYPERPUREZOMATO,46639.06,2022-04-11T07:25:47+05:30,,OTHER,,2022-04-11
DEBIT,174.72,UPI-ZOMATO LTD-ZOMATO-ORDER@PAYTM-PYTM8590832-884784049625-Z,46464.34,2022-04-11T07:28:41+05:30,,OTHER,,2022-04-11
DEBIT,168.21,J1JQGXNCNIQO7Q/RAZPHYPERPUREZOMATO,46296.13,2022-04-11T07:31:04+05:30,,OTHER,,2022-04-11
DEBIT,115.5,UPI-KAMALKISHOREMAHESHWA-Q864298454@YBL-YESB2YBLUPI-22884835,46180.63,2022-04-11T13:59:51+05:30,,OTHER,,2022-04-11
DEBIT,6825.0,UPI-KAREEM KUMAR-2290517620@YBL-HDFC4524344-163757623617-P,39355.63,2022-04-12T02:39:38+05:30,,OTHER,,2022-04-12
DEBIT,252.0,UPI-Avan Patil-0139500317@OKBIZAXIS-UTIB4817607-714532615,39103.63,2022-04-13T14:40:39+05:30,,OTHER,,2022-04-13
DEBIT,175.35,UPI-VIRAJKUMAR RATHI-PAYTMQR245093088878BGV2R7UN6OU0@PAYTM-P,38928.28,2022-04-13T14:49:02+05:30,,OTHER,,2022-04-13
DEBIT,52.5,UPI-MANGI-Q693751387@YBL-BARB2SHREED-650960961083-PAYMENT FR,38875.78,2022-04-13T15:05:02+05:30,,OTHER,,2022-04-13
DEBIT,126.0,UPI-VIJAYBHAI PUJABHAI P-PAYTMQR213122866874ZR3B96C8ACN5@PAY,38749.78,2022-04-13T15:45:18+05:30,,OTHER,,2022-04-13
DEBIT,10.5,UPI-BHARTI AIRTEL LIMITE-AIRTELPREDIRECT6@YBL-YESB3YBLUPI-99,38739.28,2022-04-14T02:19:43+05:30,,OTHER,,2022-04-14
DEBIT,105.0,UPI-PHONEPE-BILLDESKPP@YBL-YESB4YBLUPI-390112119463-PAYMENT ,38634.28,2022-04-16T05:04:58+05:30,,OTHER,,2022-04-16
DEBIT,23100.0,IB BILLPAY DR-HDFCYA-183792XXXXXX6620,15534.28,2022-04-16T09:29:28+05:30,,OTHER,,2022-04-16
DEBIT,21.0,UPI-BHARTI AIRTEL LIMITE-AIRTELPREDIRECT8@YBL-YESB6YBLUPI-10,15513.28,2022-04-16T13:00:35+05:30,,OTHER,,2022-04-16
DEBIT,63.0,UPI-UMABEN BHARATBHAI PA-PAYTMQR5685130225583IRV55BHAVKE@PAY,15450.28,2022-04-16T14:21:18+05:30,,OTHER,,2022-04-16
DEBIT,136.5,UPI-MEHUL KANABAR-PAYTMQR786855902751HUC5WQ2CUTPX@PAYTM-PYTM,15313.78,2022-04-16T15:44:59+05:30,,OTHER,,2022-04-16
DEBIT,14.7,UPI-Chander Mahato -NAYAN0660.PATEL6@YBL-BARB6ZADESH-55,15299.08,2022-04-16T15:51:19+05:30,,OTHER,,2022-04-16
DEBIT,1271.55,ACH D- LIC OF INDIA-0591580177506,14027.53,2022-04-17T05:01:04+05:30,,OTHER,,2022-04-17
DEBIT,15445.5,EMI 6861534   CHQ S27949166674 27401872021,-1417.97,2022-04-17T07:51:53+05:30,,OTHER,,2022-04-17
DEBIT,701.4,UPI-BHARTI AIRTEL LIMITE-AIRTELPREDIRECT7@YBL-YESB3YBLUPI-60,-2119.37,2022-04-17T10:43:56+05:30,,OTHER,,2022-04-17
DEBIT,31.5,UPI-Kashvi Ghosh-EAZYPAY.055571982@ICICI-ICIC8DC9411-545,-2150.87,2022-04-17T13:37:05+05:30,,OTHER,,2022-04-17
DEBIT,73.5,UPI-JAY MAHAVIR ICE CREA-PAYTMQR9014114830278SNX10BPO4TM@PAY,-2224.37,2022-04-17T17:28:50+05:30,,OTHER,,2022-04-17
DEBIT,15.75,UPI-Drisana Devi-EURONET@YBL-YESB1YBLUPI-281176215096-PAYMENT FRO,-2240.12,2022-04-18T10:36:42+05:30,,OTHER,,2022-04-18
CREDIT,10500.0,UPI-RAM RAHIM-0865711184@YBL-SBIN5067262-91552028,8259.88,2022-04-18T14:00:10+05:30,,OTHER,,2022-04-18
CREDIT,2100.0,UPI-JENISH VEKARIYA-7071161176@YBL-CNRB6874614-236710314994,10359.88,2022-04-18T16:57:02+05:30,,OTHER,,2022-04-18
CREDIT,8400.0,UPI-JENISH VEKARIYA-9595520235@YBL-CNRB5335524-844861086401,18759.88,2022-04-18T16:57:34+05:30,,OTHER,,2022-04-18
CREDIT,2100.0,UPI-KIRAN BHANUSHALI-3319386214@YBL-SBIN3199166-579771015071,20859.88,2022-04-18T16:58:21+05:30,,OTHER,,2022-04-18
DEBIT,15750.0,UPI-Anala Begum-4784600806@YBL-CBIN4480528-595305199663,5109.88,2022-04-18T17:04:21+05:30,,OTHER,,2022-04-18
DEBIT,5250.0,UPI-KIRAN BHANUSHALI-8261599190@YBL-SBIN7447566-414768417428,-140.12,2022-04-19T11:47:11+05:30,,OTHER,,2022-04-19
CREDIT,735.0,UPI-AYAN SHEIKH-9209841307@YBL-SBIN1343051-819290960918-P,594.88,2022-04-23T04:25:32+05:30,,OTHER,,2022-04-23
DEBIT,2992.5,UPI-KIRAN BHANUSHALI-9314055372@YBL-SBIN0269135-315918665738,-2397.62,2022-04-23T04:29:50+05:30,,OTHER,,2022-04-23
CREDIT,210.0,UPI-JENISH VEKARIYA-5831415911@YBL-CNRB8508949-158122986630,-2187.62,2022-04-23T04:58:03+05:30,,OTHER,,2022-04-23
DEBIT,210.0,UPI-KIRAN BHANUSHALI-3729256470@YBL-SBIN4056986-957469869151,-2397.62,2022-04-23T08:11:56+05:30,,OTHER,,2022-04-23
DEBIT,2.73,INSTA ALERT CHG JAN26-SMS(99) 570459-MIR4593967442738,-2400.35,2022-04-24T13:30:54+05:30,,OTHER,,2022-04-24
CREDIT,1890.0,UPI-Shaila Gupta-7502567693@YBL-SBIN1806146-16757652,-510.35,2022-05-04T13:55:53+05:30,,OTHER,,2022-05-04
CREDIT,525.0,UPI-NIKOLA KOVAC-NIKO.AJ@OKAXIS-SBIN9781126-86235817385,14.65,2022-05-04T14:46:11+05:30,,OTHER,,2022-05-04
CREDIT,525.0,UPI-NIKOLA KOVAC-NIKO.AJ@OKAXIS-SBIN1520646-49464096966,539.65,2022-05-04T14:49:10+05:30,,OTHER,,2022-05-04
CREDIT,525.0,UPI-ANUSHKA SHARMA-6895878875@YBL-SBIN0109935-17286215,1064.65,2022-05-04T15:28:44+05:30,,OTHER,,2022-05-04
CREDIT,2625.0,UPI-RAHI.SHAH-3506960718@YBL-BARB2KOSAMD-007291299,3689.65,2022-05-04T16:38:12+05:30,,OTHER,,2022-05-04
CREDIT,525.0,UPI-RAHI.SHAH-5618452563@YBL-BARB8KOSAMD-833246345,4214.65,2022-05-05T02:35:15+05:30,,OTHER,,2022-05-05
CREDIT,7625.0,UPI-Akshay Pal-AKSHAY12@YBL-SBIN4334444-29,11839.65,2022-05-05T04:15:47+05:30,,OTHER,,2022-05-05
DEBIT,1000.0,ACH D- TP ACH INVESCO MF-351292869,10839.65,2022-05-05T06:02:33+05:30,,OTHER,,2022-05-05
CREDIT,525.0,UPI-RAHI.SHAH-2592712848@YBL-BARB1KOSAMD-927778779,11364.65,2022-05-06T05:04:54+05:30,,OTHER,,2022-05-06
CREDIT,315.0,UPI-Kavi Behera-5803293270@YBL-SBIN7323983-01443121,11679.65,2022-05-06T08:31:25+05:30,,OTHER,,2022-05-06
DEBIT,3465.0,UPI-RANVEER SINGH-7116201932@YBL-SBIN1945015-465101354691-PAYM,8214.65,2022-05-06T09:36:14+05:30,,OTHER,,2022-05-06
DEBIT,446.25,UPI-ROYAL TEXTILE-GPAY-80846324268@OKBIZAXIS-UTIB3385228-231,7768.4,2022-05-06T15:17:09+05:30,,OTHER,,2022-05-06
DEBIT,682.5,UPI-Kashvi Prasad-1560336397@YBL-SBIN9165656-33848408,7085.9,2022-05-06T16:23:03+05:30,,OTHER,,2022-05-06
DEBIT,126.0,UPI-PLAYERZPOT MEDIA PVT-PLAYERZPOT@PAYTM-PYTM0229877-776028,6959.9,2022-05-07T03:47:55+05:30,,OTHER,,2022-05-07
DEBIT,126.0,UPI-PLAYERZPOT MEDIA PVT-PLAYERZPOT@PAYTM-PYTM9676321-645084,6833.9,2022-05-07T09:39:37+05:30,,OTHER,,2022-05-07
DEBIT,1.98,INSTA ALERT CHARGES(FEB-96) - SMS 035572-MIR3010184656185,6831.92,2022-05-07T11:04:41+05:30,,OTHER,,2022-05-07
CREDIT,1575.0,UPI-Tanaia Ma-TANIA72.SINGH11@OKICICI-ICIC3258158-04763729,8406.92,2022-05-08T11:54:13+05:30,,OTHER,,2022-05-08
DEBIT,157.5,UPI-MR PARESHBHAI GEETES-Q01110400@YBL-CBIN9114516-895285889,8249.42,2022-05-10T15:37:20+05:30,,OTHER,,2022-05-10
DEBIT,100.8,UPI-BHARATPEMERCHANT-BHARATPE.0008945903@ICICI-ICIC3DC1872-4,8148.62,2022-05-11T08:50:55+05:30,,OTHER,,2022-05-11
CREDIT,45215.1,NEFT CR-BOFA3ND3174-PIRIMID FINTECH INDIA PVT LTD-KEVAL PUROHIT RAI-646,53363.72,2022-05-11T10:26:22+05:30,,OTHER,,2022-05-11
CREDIT,5631.15,UPI-AYAN SHEIKH-1000827891@YBL-SBIN8498680-843953625570-P,58994.87,2022-05-11T11:55:30+05:30,,OTHER,,2022-05-11
CREDIT,525.0,UPI-Salina Begum-2351840177@YBL-SBIN8321339-99536690,59519.87,2022-05-11T13:00:52+05:30,,OTHER,,2022-05-11
DEBIT,115.5,UPI-MEHUL KANABAR-PAYTMQR467098880730HUC7WQ7CUTPX@PAYTM-PYTM,59404.37,2022-05-11T15:49:31+05:30,,OTHER,,2022-05-11
DEBIT,42.0,UPI-GAYATRI LOW PRICE-PAYTMQR81888159439265LHIJLB4471@PAYTM-,59362.37,2022-05-11T15:55:44+05:30,,OTHER,,2022-05-11
DEBIT,5250.0,ATW-421211XXXXXX3192-S6ANGU55-BHARUCH,54112.37,2022-05-12T02:42:53+05:30,,OTHER,,2022-05-12
DEBIT,1575.0,UPI-KIRAN BHANUSHALI-7519353898@YBL-SBIN5890979-655265442086,52537.37,2022-05-12T02:50:07+05:30,,OTHER,,2022-05-12
CREDIT,107.1,CREDIT INTEREST CAPITALISED,52644.47,2022-05-12T06:28:33+05:30,,OTHER,,2022-05-12
DEBIT,6825.0,UPI-KAREEM KUMAR-9989025441@YBL-HDFC3024444-046865151021-P,45819.47,2022-05-12T11:20:00+05:30,,OTHER,,2022-05-12
DEBIT,7535.57,IB BILLPAY DR-HDFCCC-945635XXXXXX3837,38283.9,2022-05-12T11:24:48+05:30,,OTHER,,2022-05-12
DEBIT,21.0,UPI-BHARTI AIRTEL LIMITE-AIRTELPREDIRECT0@YBL-YESB3YBLUPI-60,38262.9,2022-05-12T13:59:26+05:30,,OTHER,,2022-05-12
DEBIT,10500.0,UPI-XXXXXX0577-HDFC0439595-872989829133-PAYMENT FROM PHONE,27762.9,2022-05-14T09:19:12+05:30,,OTHER,,2022-05-14
DEBIT,6300.0,UPI-Candy Pal-AMATA4@AXL-SBIN1979589-6501,21462.9,2022-05-14T09:30:16+05:30,,OTHER,,2022-05-14
DEBIT,10.5,UPI-Damayanti Bai-0631980874@IBL-SBIN7542217-60353471,21452.4,2022-05-14T12:12:15+05:30,,OTHER,,2022-05-14
DEBIT,267.75,POS 507066XXXXXX0083 EXQUISITE CLUBS,21184.65,2022-05-14T13:46:58+05:30,,OTHER,,2022-05-14
DEBIT,245.7,POS 828111XXXXXX8749 PIZZA HUT,20938.95,2022-05-14T14:46:43+05:30,,OTHER,,2022-05-14
CREDIT,2.73,REV_INSTA ALERT CH JAN76-SMS(07) 465937-MIR5648856307495,20941.68,2022-05-16T13:06:36+05:30,,OTHER,,2022-05-16
CREDIT,1.98,REV_INSTA ALERT CHG(FEB-89) - SMS 489954-MIR0820175933860,20943.66,2022-05-17T08:29:37+05:30,,OTHER,,2022-05-17
DEBIT,1271.55,ACH D- LIC OF INDIA-9522852803533,19672.11,2022-05-18T05:16:11+05:30,,OTHER,,2022-05-18
DEBIT,15445.5,EMI 2702696   CHQ S63462598027 99650960848,4226.61,2022-05-18T07:04:15+05:30,,OTHER,,2022-05-18
CREDIT,2625.0,UPI-JENISH VEKARIYA-4838246180@YBL-HDFC2556464-208257056971,6851.61,2022-05-20T07:36:20+05:30,,OTHER,,2022-05-20
DEBIT,5250.0,IB BILLPAY DR-HDFCCC-561444XXXXXX3546,1601.61,2022-05-20T07:40:34+05:30,,OTHER,,2022-05-20
CREDIT,1050.0,UPI-KIRAN BHANUSHALI-0977797753@YBL-SBIN4975798-970188472347,2651.61,2022-05-28T09:01:55+05:30,,OTHER,,2022-05-28
DEBIT,1050.0,UPI-KIRAN BHANUSHALI-7541295713@YBL-SBIN1565002-628359138003,1601.61,2022-05-29T12:42:31+05:30,,OTHER,,2022-05-29
CREDIT,1050.0,UPI-JENISH VEKARIYA-4872384668@YBL-HDFC6863057-521658602394,2651.61,2022-05-31T03:14:05+05:30,,OTHER,,2022-05-31
CREDIT,5250.0,UPI-DAVID PATEL-DAVID248@OKHDFCBANK-HDFC0984080,7901.61,2022-05-31T05:47:28+05:30,,OTHER,,2022-05-31
DEBIT,5.25,UPI-XXXXXX2718-ICIC2629954-091992890360-PAYMENT FROM PHONE,7896.36,2022-05-31T05:48:35+05:30,,OTHER,,2022-05-31
DEBIT,5250.0,UPI-XXXXXX9117-ICIC5590229-287584407420-PAYMENT FROM PHONE,2646.36,2022-05-31T05:49:58+05:30,,OTHER,,2022-05-31
CREDIT,945.0,UPI-Kimaya Sharma-TANIA14.SINGH72-7@OKAXIS-BARB3VJANKL-,3591.36,2022-05-31T06:11:42+05:30,,OTHER,,2022-05-31
DEBIT,1915.2,UPI-HIND TRADERS-PAYTMQR091272900377FQLJ1LR612YF@PAYTM-PYTM8,1676.16,2022-05-31T08:22:18+05:30,,OTHER,,2022-05-31
CREDIT,262.5,UPI-Shantai Sarkar-5584382681@YBL-SBIN5964004-220106620163-PAY,1938.66,2022-06-04T13:50:40+05:30,,OTHER,,2022-06-04
DEBIT,1000.0,ACH D- TP ACH INVESCO MF-351292869,938.66,2022-06-05T06:02:33+05:30,,OTHER,,2022-06-05
DEBIT,126.0,UPI-PLAYERZPOT MEDIA PVT-PLAYERZPOT@PAYTM-PYTM7210627-340637,812.66,2022-06-06T04:01:38+05:30,,OTHER,,2022-06-06
DEBIT,42.0,UPI-PLAYERZPOT MEDIA PVT-PLAYERZPOT@PAYTM-PYTM7359345-744044,770.66,2022-06-06T05:06:50+05:30,,OTHER,,2022-06-06
DEBIT,126.0,UPI-PLAYERZPOT MEDIA PVT-PLAYERZPOT@PAYTM-PYTM2042360-397279,644.66,2022-06-06T05:27:02+05:30,,OTHER,,2022-06-06
DEBIT,42.0,UPI-PLAYERZPOT MEDIA PVT-PLAYERZPOT@PAYTM-PYTM5211842-716052,602.66,2022-06-06T05:46:14+05:30,,OTHER,,2022-06-06
CREDIT,52320.45,NEFT CR-BOFA8ND6450-PIRIMID FINTECH INDIA PVT LTD-KEVAL PUROHIT RAI-565,52923.11,2022-06-09T07:59:08+05:30,,OTHER,,2022-06-09
DEBIT,2285.57,IB BILLPAY DR-HDFCCC-822631XXXXXX1678,50637.54,2022-06-09T09:05:35+05:30,,OTHER,,2022-06-09
DEBIT,21000.0,IB BILLPAY DR-HDFCYA-102447XXXXXX5713,29637.54,2022-06-09T09:09:32+05:30,,OTHER,,2022-06-09
CREDIT,4794.3,UPI-AYAN SHEIKH-0785591758@YBL-SBIN6058451-085912937486-P,34431.84,2022-06-09T09:13:00+05:30,,OTHER,,2022-06-09
CREDIT,262.5,UPI-AYAN SHEIKH-2161132381@YBL-SBIN2253331-306699045466-P,34694.34,2022-06-09T09:14:48+05:30,,OTHER,,2022-06-09
DEBIT,5250.0,UPI-RUTVIK SINGH-RUTVIK.SINGH598@OKICICI-ICIC763,29444.34,2022-06-10T13:20:35+05:30,,OTHER,,2022-06-10
DEBIT,156.45,POS 541919XXXXXX6220 PAYUP*DREAM11,29287.89,2022-06-10T13:30:38+05:30,,OTHER,,2022-06-10
DEBIT,126.0,UPI-PLAYERZPOT MEDIA PVT-PLAYERZPOT@PAYTM-PYTM5877506-682562,29161.89,2022-06-10T16:46:07+05:30,,OTHER,,2022-06-10
DEBIT,42.0,UPI-PLAYERZPOT MEDIA PVT-PLAYERZPOT@PAYTM-PYTM6071557-691538,29119.89,2022-06-10T17:06:13+05:30,,OTHER,,2022-06-10
DEBIT,435.75,UPI-PLAYERZPOT MEDIA PVT-PLAYERZPOT@PAYTM-PYTM8675404-084064,28684.14,2022-06-11T05:19:44+05:30,,OTHER,,2022-06-11
DEBIT,2804.55,UPI-AYAN SHEIKH-2340983920@YBL-SBIN1633602-913920467481-P,25879.59,2022-06-11T07:06:30+05:30,,OTHER,,2022-06-11
DEBIT,603.75,UPI-PLAYERZPOT MEDIA PVT-PLAYERZPOT@PAYTM-PYTM5118923-639539,25275.84,2022-06-11T07:11:46+05:30,,OTHER,,2022-06-11
DEBIT,2100.0,UPI-Aja Kaur-BHARATRAY713@YBL-UBIN7999,23175.84,2022-06-11T09:52:51+05:30,,OTHER,,2022-06-11
CREDIT,1120.35,IMPS-403762668892-Damayanti Patel-RATN-XXXXXXXX2459-MAYS,24296.19,2022-06-11T13:24:55+05:30,,OTHER,,2022-06-11
CREDIT,1120.35,IMPS-931547448336-Chander Devi-RATN-XXXXXXXX8089-MAYS,25416.54,2022-06-11T13:24:56+05:30,,OTHER,,2022-06-11
DEBIT,103.95,POS 541919XXXXXX6220 DREAM11 FANTASY,25312.59,2022-06-11T13:30:16+05:30,,OTHER,,2022-06-11
DEBIT,105.0,UPI-MUKESHBHAI SHAH-PAYTMQR129249562433G6JW8QZFK3E5@PAYTM-PY,25207.59,2022-06-11T14:42:50+05:30,,OTHER,,2022-06-11
DEBIT,433.12,POS 358772XXXXXX9821 RSP*ZOMATO LIMIT,24774.47,2022-06-12T14:21:23+05:30,,OTHER,,2022-06-12
CREDIT,1359.75,IMPS-841367242595-Kamala Das 2-ICIC-XXXXXXXX1406-PLA,26134.22,2022-06-12T14:29:25+05:30,,OTHER,,2022-06-12
CREDIT,1050.0,IMPS-112009881877-FIDUCIARY BILLING SO-INDB-XXXXXXXX7052-,27184.22,2022-06-12T14:32:30+05:30,,OTHER,,2022-06-12
DEBIT,126.0,UPI-PLAYERZPOT MEDIA PVT-PLAYERZPOT@PAYTM-PYTM5015735-961727,27058.22,2022-06-12T15:02:28+05:30,,OTHER,,2022-06-12
DEBIT,126.0,UPI-PLAYERZPOT MEDIA PVT-PLAYERZPOT@PAYTM-PYTM3306756-020957,26932.22,2022-06-12T15:16:32+05:30,,OTHER,,2022-06-12
DEBIT,84.0,UPI-PLAYERZPOT MEDIA PVT-PLAYERZPOT@PAYTM-PYTM5230608-982570,26848.22,2022-06-12T17:03:46+05:30,,OTHER,,2022-06-12
DEBIT,126.0,UPI-PLAYERZPOT MEDIA PVT-PLAYERZPOT@PAYTM-PYTM0753202-473759,26722.22,2022-06-13T13:42:48+05:30,,OTHER,,2022-06-13
DEBIT,603.75,UPI-PLAYERZPOT MEDIA PVT-PLAYERZPOT@PAYTM-PYTM6731470-957452,26118.47,2022-06-13T13:50:43+05:30,,OTHER,,2022-06-13
CREDIT,876.75,IMPS-252568541654-Aditi Pal 1-ICIC-XXXXXXXX7487-PLA,26995.22,2022-06-13T15:05:47+05:30,,OTHER,,2022-06-13
DEBIT,126.0,UPI-PLAYERZPOT MEDIA PVT-PLAYERZPOT@PAYTM-PYTM0984136-170849,26869.22,2022-06-13T16:24:48+05:30,,OTHER,,2022-06-13
DEBIT,42.0,UPI-PLAYERZPOT MEDIA PVT-PLAYERZPOT@PAYTM-PYTM7960906-931635,26827.22,2022-06-14T01:15:04+05:30,,OTHER,,2022-06-14
CREDIT,433.12,POS REF 972698******1908-41/08 ZOMATOLI2,27260.34,2022-06-14T07:41:50+05:30,,OTHER,,2022-06-14
CREDIT,1050.0,UPI-Shantai Ansari-TANIA35.SINGH08-1@OKAXIS-BARB3VJANKL-,28310.34,2022-06-14T12:12:47+05:30,,OTHER,,2022-06-14
DEBIT,1050.0,UPI-KIRAN BHANUSHALI-2887735446@YBL-SBIN7763720-671842776259,27260.34,2022-06-14T12:35:00+05:30,,OTHER,,2022-06-14
DEBIT,126.0,UPI-PLAYERZPOT MEDIA PVT-PLAYERZPOT@PAYTM-PYTM2002339-732152,27134.34,2022-06-14T15:13:25+05:30,,OTHER,,2022-06-14
DEBIT,42.0,UPI-PLAYERZPOT MEDIA PVT-PLAYERZPOT@PAYTM-PYTM9396398-023890,27092.34,2022-06-14T15:34:48+05:30,,OTHER,,2022-06-14
CREDIT,456.75,IMPS-176139622087-Neha Mondal 0-ICIC-XXXXXXXX2385-PLA,27549.09,2022-06-14T16:38:35+05:30,,OTHER,,2022-06-14
DEBIT,126.0,UPI-PLAYERZPOT MEDIA PVT-PLAYERZPOT@PAYTM-PYTM0368908-406229,27423.09,2022-06-15T13:33:49+05:30,,OTHER,,2022-06-15
DEBIT,105.0,UPI-BHARTI AIRTEL LIMITE-AIRTELPREDIRECT5@YBL-YESB5YBLUPI-17,27318.09,2022-06-15T13:49:40+05:30,,OTHER,,2022-06-15
DEBIT,42.0,UPI-PLAYERZPOT MEDIA PVT-PLAYERZPOT@PAYTM-PYTM6852178-635132,27276.09,2022-06-15T17:35:06+05:30,,OTHER,,2022-06-15
DEBIT,84.0,UPI-BHARATPEMERCHANT-BHARATPE.8664235004@ICICI-ICIC3DC9139-8,27192.09,2022-06-16T08:20:18+05:30,,OTHER,,2022-06-16
CREDIT,652.05,IMPS-570993011666-Shalene Barman PRIVATE LIM-KKBK-XXXXXX2880-DREAM,27844.14,2022-06-16T11:10:38+05:30,,OTHER,,2022-06-16
DEBIT,126.0,UPI-PLAYERZPOT MEDIA PVT-PLAYERZPOT@PAYTM-PYTM1609788-992571,27718.14,2022-06-16T13:34:56+05:30,,OTHER,,2022-06-16
DEBIT,194.63,JRZPTR1NJQYD6X/RAZPHYPERPUREZOMATO,27523.51,2022-06-16T15:39:41+05:30,,OTHER,,2022-06-16
DEBIT,1271.55,ACH D- LIC OF INDIA-4276867401454,26251.96,2022-06-17T04:11:09+05:30,,OTHER,,2022-06-17
CREDIT,7350.0,UPI-ANUSHKA SHARMA-8840808340@APL-SBIN2789962-00919119,33601.96,2022-06-17T04:11:26+05:30,,OTHER,,2022-06-17
DEBIT,15445.5,EMI 8200995   CHQ S87259758911 35661512689,18156.46,2022-06-17T06:32:56+05:30,,OTHER,,2022-06-17
DEBIT,5117.7,UPI-Mayur Gupta-DAMAYANTI2590@YBL-SBIN3951343-269799,13038.76,2022-06-17T06:37:22+05:30,,OTHER,,2022-06-17
DEBIT,3150.0,UPI-KIRAN BHANUSHALI-9641706150@YBL-SBIN1899603-976293706678,9888.76,2022-06-17T08:18:03+05:30,,OTHER,,2022-06-17
DEBIT,42.0,UPI-PLAYERZPOT MEDIA PVT-PLAYERZPOT@PAYTM-PYTM0371171-183459,9846.76,2022-06-17T17:06:24+05:30,,OTHER,,2022-06-17
DEBIT,603.75,UPI-PLAYERZPOT MEDIA PVT-PLAYERZPOT@PAYTM-PYTM7861786-378039,9243.01,2022-06-18T03:29:25+05:30,,OTHER,,2022-06-18
CREDIT,666.75,IMPS-154002413337-Akhilesh Mishra 6-ICIC-XXXXXXXX6735-PLA,9909.76,2022-06-18T05:02:50+05:30,,OTHER,,2022-06-18
DEBIT,126.0,UPI-PLAYERZPOT MEDIA PVT-PLAYERZPOT@PAYTM-PYTM5212003-796352,9783.76,2022-06-18T05:18:13+05:30,,OTHER,,2022-06-18
DEBIT,385.35,POS 541919XXXXXX6220 PAYUP*DREAM11,9398.41,2022-06-18T10:15:18+05:30,,OTHER,,2022-06-18
DEBIT,131.25,POS 541919XXXXXX6220 PAYUP*DREAM11,9267.16,2022-06-18T14:14:43+05:30,,OTHER,,2022-06-18
CREDIT,1050.0,IMPS-368028595206-FIDUCIARY BILLING SO-YESB-XXXXXXXXXXX1270-,10317.16,2022-06-18T15:05:24+05:30,,OTHER,,2022-06-18
CREDIT,341.25,IMPS-835590194825-FIDUCIARY BILLING SO-YESB-XXXXXXXXXXX3585-,10658.41,2022-06-18T18:12:47+05:30,,OTHER,,2022-06-18
DEBIT,42.0,UPI-PLAYERZPOT MEDIA PVT-PLAYERZPOT@PAYTM-PYTM0489241-658614,10616.41,2022-06-19T03:26:35+05:30,,OTHER,,2022-06-19
DEBIT,4725.0,UPI-KIRAN BHANUSHALI-4446196931@YBL-SBIN1993224-597860756872,5891.41,2022-06-19T04:08:51+05:30,,OTHER,,2022-06-19
DEBIT,393.75,UPI-PLAYERZPOT MEDIA PVT-PLAYERZPOT@PAYTM-PYTM4005406-975949,5497.66,2022-06-19T05:07:09+05:30,,OTHER,,2022-06-19
DEBIT,603.75,UPI-PLAYERZPOT MEDIA PVT-PLAYERZPOT@PAYTM-PYTM4335987-323764,4893.91,2022-06-19T05:17:34+05:30,,OTHER,,2022-06-19
DEBIT,603.75,UPI-PLAYERZPOT MEDIA PVT-PLAYERZPOT@PAYTM-PYTM3793259-514488,4290.16,2022-06-19T05:27:54+05:30,,OTHER,,2022-06-19
DEBIT,157.5,UPI-PLAYERZPOT MEDIA PVT-PLAYERZPOT@PAYTM-PYTM5701987-305556,4132.66,2022-06-19T05:56:28+05:30,,OTHER,,2022-06-19
DEBIT,1050.0,ATW-144834XXXXXX3726-S5AWBH46-BHARUCH,3082.66,2022-06-19T11:59:30+05:30,,OTHER,,2022-06-19
DEBIT,220.5,UPI-JAY BHAWANI SWEETS-BHARATPE.8738030576@FBPE-FDRL2322568-,2862.16,2022-06-22T15:19:34+05:30,,OTHER,,2022-06-22
DEBIT,42.0,UPI-BHARATPEMERCHANT-BHARATPE.9278838210@ICICI-ICIC2DC4614-9,2820.16,2022-06-23T08:16:23+05:30,,OTHER,,2022-06-23
CREDIT,97.65,UPI-Amata Bai-7222264041@YBL-SBIN6623455-07730393,2917.81,2022-06-23T13:19:35+05:30,,OTHER,,2022-06-23
CREDIT,3150.0,UPI-Varun Shaikh-0783124282@YBL-SBIN3962047-36563792,6067.81,2022-06-24T16:16:40+05:30,,OTHER,,2022-06-24
DEBIT,5250.0,UPI-Bharat Ray-BHARATRAY988@YBL-UBIN9777,817.81,2022-06-24T16:20:15+05:30,,OTHER,,2022-06-24
CREDIT,10500.0,UPI-Reva Rathod-0748813989@YBL-SBIN3098154-48528227,11317.81,2022-06-25T07:00:31+05:30,,OTHER,,2022-06-25
CREDIT,38850.0,UPI-KIRAN BHANUSHALI-7979411618@YBL-SBIN0948702-296424106979,50167.81,2022-06-26T12:38:24+05:30,,OTHER,,2022-06-26
CREDIT,420.0,UPI-JENISH VEKARIYA-7674513444@YBL-HDFC6453476-157833100559,50587.81,2022-06-26T12:38:52+05:30,,OTHER,,2022-06-26
DEBIT,3150.0,UPI-AYAN SHEIKH-9608739424@YBL-SBIN0870870-278933986124-P,47437.81,2022-06-27T05:12:24+05:30,,OTHER,,2022-06-27
DEBIT,15750.0,UPI-DARSHAN SHARMA-SHARMA6833@OKICICI-ICIC4546342-391806744,31687.81,2022-06-27T06:31:14+05:30,,OTHER,,2022-06-27
DEBIT,15750.0,UPI-Amitabh Paramar-KS6204721@OKSBI-SBIN4121720-4779728,15937.81,2022-06-27T06:40:22+05:30,,OTHER,,2022-06-27
DEBIT,63.0,UPI-BHARATPEMERCHANT-BHARATPE.6753249586@ICICI-ICIC3DC8970-4,15874.81,2022-06-27T08:21:43+05:30,,OTHER,,2022-06-27
DEBIT,380.1,POS 363961XXXXXX9025 DREAM 99,15494.71,2022-06-27T14:14:14+05:30,,OTHER,,2022-06-27
DEBIT,12600.0,UPI-KIRAN BHANUSHALI-9036448379@YBL-SBIN8405971-686877178109,2894.71,2022-06-27T15:06:08+05:30,,OTHER,,2022-06-27
DEBIT,105.0,UPI-BHARTI AIRTEL LIMITE-AIRTELPREDIRECT2@YBL-YESB5YBLUPI-32,2789.71,2022-06-27T15:51:38+05:30,,OTHER,,2022-06-27
DEBIT,541.27,POS 377556XXXXXX2100 ZOMATO,2248.44,2022-06-28T07:11:48+05:30,,OTHER,,2022-06-28
DEBIT,42.0,UPI-BHARATPEMERCHANT-BHARATPE.2505206478@ICICI-ICIC1DC9802-9,2206.44,2022-06-28T08:31:15+05:30,,OTHER,,2022-06-28
DEBIT,42.0,UPI-BHARATPEMERCHANT-BHARATPE.3772984624@ICICI-ICIC8DC6090-6,2164.44,2022-06-28T12:21:34+05:30,,OTHER,,2022-06-28
DEBIT,1575.0,UPI-AYAN SHEIKH-3694178635@YBL-SBIN5299323-262972003812-P,589.44,2022-06-29T10:05:27+05:30,,OTHER,,2022-06-29
CREDIT,1050.0,UPI-KIRAN BHANUSHALI-5364968196@YBL-SBIN3168579-265980388330,1639.44,2022-07-02T01:43:06+05:30,,OTHER,,2022-07-02
DEBIT,1051.05,UPI-Bharat Sahu-BHARAT@YESBANK-YESB8837628-04,588.39,2022-07-02T02:23:49+05:30,,OTHER,,2022-07-02
DEBIT,1000.0,ACH D- TP ACH INVESCO MF-351292869,-411.61,2022-07-05T06:02:33+05:30,,OTHER,,2022-07-05
CREDIT,10500.0,UPI-Mayur Ram-6418287349@AXL-ICIC5202948-151270872865-PA,10088.39,2022-07-08T10:53:30+05:30,,OTHER,,2022-07-08
DEBIT,1051.05,UPI-Shaila Rani-Shaila RaniIPP@YESBANK-YESB0475955,9037.34,2022-07-08T12:00:43+05:30,,OTHER,,2022-07-08
DEBIT,9450.0,IB BILLPAY DR-HDFCYA-442634XXXXXX6548,-412.66,2022-07-08T21:47:00+05:30,,OTHER,,2022-07-08
CREDIT,14385.0,UPI-KIRAN BHANUSHALI-6342746811@YBL-SBIN1728945-637353738057,13972.34,2022-07-09T05:11:45+05:30,,OTHER,,2022-07-09
DEBIT,14385.0,IB BILLPAY DR-HDFCYA-398498XXXXXX3498,-412.66,2022-07-09T05:13:08+05:30,,OTHER,,2022-07-09
CREDIT,52330.95,NEFT CR-BOFA4ND9850-PIRIMID FINTECH INDIA PVT LTD-KEVAL PUROHIT RAI-234,51918.29,2022-07-11T03:46:14+05:30,,OTHER,,2022-07-11
DEBIT,7535.57,IB BILLPAY DR-HDFCCC-412735XXXXXX5686,44382.72,2022-07-11T03:51:09+05:30,,OTHER,,2022-07-11
DEBIT,15750.0,IB BILLPAY DR-HDFCYA-350349XXXXXX3381,28632.72,2022-07-11T03:52:52+05:30,,OTHER,,2022-07-11
DEBIT,1051.05,UPI-MATAMMAL-MATAMAALIPP6@YESBANK-YESB6944075-901010458795-I,27581.67,2022-07-11T08:28:25+05:30,,OTHER,,2022-07-11
CREDIT,6469.05,UPI-AYAN SHEIKH-9362851722@YBL-SBIN0372716-592628975884-P,34050.72,2022-07-11T10:30:26+05:30,,OTHER,,2022-07-11
DEBIT,10500.0,IB BILLPAY DR-HDFCYA-421041XXXXXX2666,23550.72,2022-07-11T14:09:57+05:30,,OTHER,,2022-07-11
DEBIT,5250.0,IB BILLPAY DR-HDFCYA-709522XXXXXX0392,18300.72,2022-07-11T14:18:54+05:30,,OTHER,,2022-07-11
DEBIT,168.0,UPI-GURUNG CHANDRAJ PREM-PAYTMQR8902626203348LBAJJ5KF1ZC@PAY,18132.72,2022-07-11T15:10:02+05:30,,OTHER,,2022-07-11
DEBIT,168.0,UPI-GHARIA YASH RAJENDRA-PAYTMQR211045816291KXUXNYERBJKF@PAY,17964.72,2022-07-11T15:10:53+05:30,,OTHER,,2022-07-11
DEBIT,84.0,UPI-NIKUNJ MUKUNDBHAI DA-PAYTMQR091198056051W3RKIT24KM5H@PAY,17880.72,2022-07-11T15:13:50+05:30,,OTHER,,2022-07-11
DEBIT,126.0,UPI-GHARIA YASH RAJENDRA-PAYTMQR333082754065KXUXNYERBJKF@PAY,17754.72,2022-07-11T15:43:44+05:30,,OTHER,,2022-07-11
DEBIT,603.75,UPI-PLAYERZPOT MEDIA PVT-PLAYERZPOT@PAYTM-PYTM4656695-877166,17150.97,2022-07-12T12:06:00+05:30,,OTHER,,2022-07-12
DEBIT,603.75,UPI-PLAYERZPOT MEDIA PVT-PLAYERZPOT@PAYTM-PYTM7948396-875334,16547.22,2022-07-12T12:17:05+05:30,,OTHER,,2022-07-12
CREDIT,9975.0,UPI-JENISH VEKARIYA-0463359506@YBL-HDFC6148265-193117984618,26522.22,2022-07-12T14:19:22+05:30,,OTHER,,2022-07-12
DEBIT,1051.05,UPI-MATAMMAL-MATAMAALIPP5@YESBANK-YESB3853176-155041131030-P,25471.17,2022-07-13T02:46:52+05:30,,OTHER,,2022-07-13
DEBIT,73.5,UPI-BHARATPEMERCHANT-BHARATPE.8462400233@ICICI-ICIC3DC0076-9,25397.67,2022-07-14T07:35:33+05:30,,OTHER,,2022-07-14
DEBIT,8400.0,IB BILLPAY DR-HDFCYA-618296XXXXXX7069,16997.67,2022-07-15T18:11:14+05:30,,OTHER,,2022-07-15
DEBIT,26.25,UPI-Janitra Ray-EURONET@YBL-YESB6YBLUPI-894495663424-PAYMENT FRO,16971.42,2022-07-16T09:30:02+05:30,,OTHER,,2022-07-16
DEBIT,211.05,UPI-MATAMMAL-MATAMAALIPP0@YESBANK-YESB5355868-199243057958-P,16760.37,2022-07-16T10:35:56+05:30,,OTHER,,2022-07-16
DEBIT,211.05,UPI-MATAMMAL-MATAMAALIPP4@YESBANK-YESB7442897-470855755510-P,16549.32,2022-07-16T10:43:14+05:30,,OTHER,,2022-07-16
DEBIT,53.55,UPI-MATAMMAL-MATAMAALIPP6@YESBANK-YESB7849029-888679872314-P,16495.77,2022-07-16T10:47:18+05:30,,OTHER,,2022-07-16
DEBIT,105.0,UPI-RUTVIK SINGH-RUTVIK.SINGH160@OKICICI-ICIC706,16390.77,2022-07-17T02:34:48+05:30,,OTHER,,2022-07-17
CREDIT,525.0,UPI-RUTVIK SINGH-RUTVIK.SINGH080@OKICICI-ICIC710,16915.77,2022-07-17T02:36:29+05:30,,OTHER,,2022-07-17
CREDIT,105.0,UPI-RUTVIK SINGH-RUTVIK.SINGH798@OKICICI-ICIC134,17020.77,2022-07-17T02:36:48+05:30,,OTHER,,2022-07-17
DEBIT,526.05,UPI-MATAMMAL-MATAMAALIPP9@YESBANK-YESB1287202-229814523079-P,16494.72,2022-07-17T05:25:51+05:30,,OTHER,,2022-07-17
CREDIT,525.0,UPI-RANVEER SINGH-5285014310@YBL-SBIN1065497-107405950817-PAYM,17019.72,2022-07-18T06:00:25+05:30,,OTHER,,2022-07-18
DEBIT,526.05,UPI-MATAMMAL-MATAMAALIPP0@YESBANK-YESB3509598-364901682397-I,16493.67,2022-07-18T06:03:32+05:30,,OTHER,,2022-07-18
DEBIT,1271.55,ACH D- LIC OF INDIA-7724277074646,15222.12,2022-07-18T06:21:36+05:30,,OTHER,,2022-07-18
DEBIT,157.5,UPI-Mahika Jadhav-FPAISA@AXISBANK-UTIB0744993-1893302,15064.62,2022-07-18T07:24:34+05:30,,OTHER,,2022-07-18
CREDIT,525.0,UPI-JENISH VEKARIYA-1832925447@YBL-HDFC7704106-319165036398,15589.62,2022-07-18T08:09:37+05:30,,OTHER,,2022-07-18
DEBIT,21.0,UPI-BHARATPEMERCHANT-BHARATPE.9363953059@ICICI-ICIC8DC7962-3,15568.62,2022-07-18T08:30:38+05:30,,OTHER,,2022-07-18
CREDIT,150000.0,NEFT CR-BOFA0ND6316-CHINTAN SHETH-KEVAL PUROHIT-1235,165568.62,2022-07-18T08:30:38+05:30,,OTHER,,2022-07-18
DEBIT,7000.0,FD BOOKED - 503006822 : KARPIT VORA,158568.62,2022-07-18T10:30:38+05:30,,OTHER,,2022-07-18
DEBIT,15445.5,EMI 7127555   CHQ S59252790483 55322251105,143123.12,2022-07-18T12:32:18+05:30,,OTHER,,2022-07-18
DEBIT,110.25,UPI-BHARATPEMERCHANT-BHARATPE.8426442261@ICICI-ICIC8DC7910-5,143012.87,2022-07-19T08:31:56+05:30,,OTHER,,2022-07-19
DEBIT,36.75,UPI-BHARATPEMERCHANT-BHARATPE.9081850600@ICICI-ICIC0DC4028-8,142976.12,2022-07-19T08:43:06+05:30,,OTHER,,2022-07-19
DEBIT,126.0,UPI-PLAYERZPOT MEDIA PVT-PLAYERZPOT@PAYTM-PYTM6881151-180965,142850.12,2022-07-19T11:07:13+05:30,,OTHER,,2022-07-19
CREDIT,315.0,UPI-Aja Patel-9749764621@YBL-SBIN7935813-633240601,143165.12,2022-07-19T12:34:42+05:30,,OTHER,,2022-07-19
DEBIT,126.0,UPI-PLAYERZPOT MEDIA PVT-PLAYERZPOT@PAYTM-PYTM8592344-046788,143039.12,2022-07-19T13:34:36+05:30,,OTHER,,2022-07-19
DEBIT,126.0,UPI-PLAYERZPOT MEDIA PVT-PLAYERZPOT@PAYTM-PYTM5009127-056297,142913.12,2022-07-20T09:20:01+05:30,,OTHER,,2022-07-20
DEBIT,61.95,UPI-BHARTI AIRTEL LIMITE-AIRTELPREDIRECT6@YBL-YESB8YBLUPI-98,142851.17,2022-07-22T00:59:10+05:30,,OTHER,,2022-07-22
DEBIT,126.0,UPI-PLAYERZPOT MEDIA PVT-PLAYERZPOT@PAYTM-PYTM2554896-478403,142725.17,2022-07-23T03:41:16+05:30,,OTHER,,2022-07-23
DEBIT,42.0,UPI-PLAYERZPOT MEDIA PVT-PLAYERZPOT@PAYTM-PYTM3110823-582712,142683.17,2022-07-23T03:54:39+05:30,,OTHER,,2022-07-23
DEBIT,84.0,UPI-PLAYERZPOT MEDIA PVT-PLAYERZPOT@PAYTM-PYTM7782445-107606,142599.17,2022-07-23T04:40:19+05:30,,OTHER,,2022-07-23
CREDIT,1124.55,IMPS-008049314665-Shylah Behera PVT LTD-YESB-XXXXXXXXXXX8308-PLAYERZP,143723.72,2022-07-23T12:23:01+05:30,,OTHER,,2022-07-23
DEBIT,25.2,UPI-PLAYERZPOT MEDIA PVT-PLAYERZPOT@PAYTM-PYTM7139534-314785,143698.52,2022-07-23T15:44:22+05:30,,OTHER,,2022-07-23
DEBIT,26.25,UPI-PLAYERZPOT MEDIA PVT-PLAYERZPOT@PAYTM-PYTM6674286-127613,143672.27,2022-07-23T16:48:23+05:30,,OTHER,,2022-07-23
DEBIT,126.0,UPI-PLAYERZPOT MEDIA PVT-PLAYERZPOT@PAYTM-PYTM1379851-094627,143546.27,2022-07-24T11:24:10+05:30,,OTHER,,2022-07-24
DEBIT,211.05,UPI-Ashwin Begam-Ashwin BegamIPP@YESBANK-YESB6567518-639570252906-PA,143335.22,2022-07-24T11:59:30+05:30,,OTHER,,2022-07-24
DEBIT,126.0,UPI-PLAYERZPOT MEDIA PVT-PLAYERZPOT@PAYTM-PYTM7830441-960614,143209.22,2022-07-24T15:31:18+05:30,,OTHER,,2022-07-24
CREDIT,997.5,IMPS-776151830151-Avan Chand PVT LTD-YESB-XXXXXXXXXXX1495-PLAYERZP,144206.72,2022-07-24T17:16:00+05:30,,OTHER,,2022-07-24
DEBIT,126.0,UPI-PLAYERZPOT MEDIA PVT-PLAYERZPOT@PAYTM-PYTM3900681-061631,144080.72,2022-07-25T03:02:26+05:30,,OTHER,,2022-07-25
DEBIT,84.0,UPI-PLAYERZPOT MEDIA PVT-PLAYERZPOT@PAYTM-PYTM1976081-339426,143996.72,2022-07-25T03:31:54+05:30,,OTHER,,2022-07-25
DEBIT,42.0,UPI-PLAYERZPOT MEDIA PVT-PLAYERZPOT@PAYTM-PYTM7010896-904834,143954.72,2022-07-25T03:53:22+05:30,,OTHER,,2022-07-25
DEBIT,525.0,UPI-Tanaia Saha-CSL-FZ.AIRPAY@SBI-SBIN6791170-112120367082-NA,143429.72,2022-07-25T12:30:24+05:30,,OTHER,,2022-07-25
DEBIT,330.75,UPI-PLAYERZPOT MEDIA PVT-PLAYERZPOT@PAYTM-PYTM2948663-129421,143098.97,2022-07-25T14:41:28+05:30,,OTHER,,2022-07-25
CREDIT,1139.25,IMPS-158241457172-Arti Sharma PVT LTD-YESB-XXXXXXXXXXX7099-PLAYERZP,144238.22,2022-07-25T19:00:27+05:30,,OTHER,,2022-07-25
DEBIT,53.55,UPI-Neha Sah-Neha SahIPP@YESBANK-YESB9380454-373526151971-PA,144184.67,2022-07-26T03:44:44+05:30,,OTHER,,2022-07-26
DEBIT,211.05,UPI-Shantai Mandal-Shantai MandalIPP@YESBANK-YESB1984831-648810623149-PA,143973.62,2022-07-26T07:27:36+05:30,,OTHER,,2022-07-26
CREDIT,1050.0,UPI-JENISH VEKARIYA-6070195899@YBL-HDFC6980225-136269605812,145023.62,2022-07-26T15:28:13+05:30,,OTHER,,2022-07-26
DEBIT,1124.55,UPI-PHONEPE-BBPSBP@YBL-YESB4YBLUPI-767219968293-PAYMENT FROM,143899.07,2022-07-26T15:32:55+05:30,,OTHER,,2022-07-26
DEBIT,624.75,UPI-PLAYERZPOT MEDIA PVT-PLAYERZPOT@PAYTM-PYTM1719868-578251,143274.32,2022-07-27T01:12:03+05:30,,OTHER,,2022-07-27
DEBIT,624.75,UPI-PLAYERZPOT MEDIA PVT-PLAYERZPOT@PAYTM-PYTM4911092-075740,142649.57,2022-07-27T01:36:27+05:30,,OTHER,,2022-07-27
CREDIT,1853.25,IMPS-140539479303-Sahil Ram PVT LTD-YESB-XXXXXXXXXXX4739-PLAYERZP,144502.82,2022-07-27T10:17:26+05:30,,OTHER,,2022-07-27
DEBIT,525.0,UPI-Shalene Biswas-CSL-FZ.AIRPAY@SBI-SBIN6013522-966350198594-NA,143977.82,2022-07-27T11:12:58+05:30,,OTHER,,2022-07-27
DEBIT,126.0,UPI-PLAYERZPOT MEDIA PVT-PLAYERZPOT@PAYTM-PYTM1409079-434997,143851.82,2022-07-27T13:03:15+05:30,,OTHER,,2022-07-27
DEBIT,126.0,UPI-PLAYERZPOT MEDIA PVT-PLAYERZPOT@PAYTM-PYTM2441436-165907,143725.82,2022-07-27T13:15:03+05:30,,OTHER,,2022-07-27
DEBIT,126.0,UPI-PLAYERZPOT MEDIA PVT-PLAYERZPOT@PAYTM-PYTM9634144-264658,143599.82,2022-07-27T13:25:54+05:30,,OTHER,,2022-07-27
DEBIT,456.75,UPI-PLAYERZPOT MEDIA PVT-PLAYERZPOT@PAYTM-PYTM3414689-965471,143143.07,2022-07-27T18:15:35+05:30,,OTHER,,2022-07-27
DEBIT,525.0,UPI-KIRAN BHANUSHALI-8278857830@YBL-SBIN2795090-045803930495,142618.07,2022-07-28T13:43:09+05:30,,OTHER,,2022-07-28
CREDIT,525.0,UPI-KIRAN BHANUSHALI-4103138543@YBL-SBIN0364990-864296931127,143143.07,2022-07-30T05:07:47+05:30,,OTHER,,2022-07-30
DEBIT,525.0,UPI-Marjane Kaur-CSL-FZ.AIRPAY@SBI-SBIN8417929-644008081129-NA,142618.07,2022-07-30T05:28:49+05:30,,OTHER,,2022-07-30
CREDIT,1874.25,IMPS-196412828546-Prasad Ali PVT LTD-YESB-XXXXXXXXXXX5280-PLAYERZP,144492.32,2022-07-30T12:35:00+05:30,,OTHER,,2022-07-30
DEBIT,630.0,IB BILLPAY DR-HDFCYA-710954XXXXXX7800,143862.32,2022-07-30T12:38:01+05:30,,OTHER,,2022-07-30
DEBIT,126.0,UPI-PLAYERZPOT MEDIA PVT-PLAYERZPOT@PAYTM-PYTM3141770-115242,143736.32,2022-07-30T16:23:53+05:30,,OTHER,,2022-07-30
DEBIT,126.0,UPI-PLAYERZPOT MEDIA PVT-PLAYERZPOT@PAYTM-PYTM1757041-448124,143610.32,2022-07-30T16:24:40+05:30,,OTHER,,2022-07-30
DEBIT,42.0,UPI-PLAYERZPOT MEDIA PVT-PLAYERZPOT@PAYTM-PYTM1158050-514480,143568.32,2022-07-30T16:57:18+05:30,,OTHER,,2022-07-30
DEBIT,126.0,UPI-PLAYERZPOT MEDIA PVT-PLAYERZPOT@PAYTM-PYTM4857547-741847,143442.32,2022-07-30T17:13:35+05:30,,OTHER,,2022-07-30
DEBIT,525.0,UPI-Aadhira Shaikh-CSL-FZ.AIRPAY@SBI-SBIN1551166-632930180330-NA,142917.32,2022-07-31T06:37:19+05:30,,OTHER,,2022-07-31
DEBIT,119.7,UPI-PLAYERZPOT MEDIA PVT-PLAYERZPOT@PAYTM-PYTM2752099-440614,142797.62,2022-07-31T13:13:47+05:30,,OTHER,,2022-07-31
CREDIT,1223.25,IMPS-604225014549-Ashwin Begam PVT LTD-YESB-XXXXXXXXXXX6708-PLAYERZP,144020.87,2022-07-31T18:01:13+05:30,,OTHER,,2022-07-31
DEBIT,126.0,UPI-PLAYERZPOT MEDIA PVT-PLAYERZPOT@PAYTM-PYTM9503874-453514,143894.87,2022-07-31T18:07:03+05:30,,OTHER,,2022-07-31
DEBIT,63.0,UPI-PLAYERZPOT MEDIA PVT-PLAYERZPOT@PAYTM-PYTM7474204-545934,143831.87,2022-07-31T18:17:34+05:30,,OTHER,,2022-07-31
DEBIT,21.0,UPI-PLAYERZPOT MEDIA PVT-PLAYERZPOT@PAYTM-PYTM0179587-192468,143810.87,2022-08-01T01:42:15+05:30,,OTHER,,2022-08-01
DEBIT,525.0,UPI-Ambar Rani-CSL-FZ.AIRPAY@SBI-SBIN7417469-888178728994-NA,143285.87,2022-08-01T09:31:43+05:30,,OTHER,,2022-08-01
CREDIT,1.05,IMPS-476514819795-NEXTBILLION TECHNOLO-YESB-XXXXXXXXXXX5143-,143286.92,2022-08-01T10:51:52+05:30,,OTHER,,2022-08-01
DEBIT,624.75,UPI-PLAYERZPOT MEDIA PVT-PLAYERZPOT@PAYTM-PYTM7510084-819922,142662.17,2022-08-01T17:40:54+05:30,,OTHER,,2022-08-01
CREDIT,1097.25,IMPS-323511738627-Akshay Nayak PVT LTD-YESB-XXXXXXXXXXX2961-PLAYERZP,143759.42,2022-08-01T18:36:16+05:30,,OTHER,,2022-08-01
DEBIT,126.0,UPI-PLAYERZPOT MEDIA PVT-PLAYERZPOT@PAYTM-PYTM3107766-392697,143633.42,2022-08-02T02:11:51+05:30,,OTHER,,2022-08-02
DEBIT,126.0,UPI-PLAYERZPOT MEDIA PVT-PLAYERZPOT@PAYTM-PYTM9240330-111314,143507.42,2022-08-02T02:18:54+05:30,,OTHER,,2022-08-02
DEBIT,525.0,UPI-Amata Paramar-CSL-FZ.AIRPAY@SBI-SBIN4056681-278928277890-NA,142982.42,2022-08-02T09:13:55+05:30,,OTHER,,2022-08-02
DEBIT,126.0,UPI-PLAYERZPOT MEDIA PVT-PLAYERZPOT@PAYTM-PYTM3599531-396694,142856.42,2022-08-02T13:48:31+05:30,,OTHER,,2022-08-02
DEBIT,115.5,UPI-PLAYERZPOT MEDIA PVT-PLAYERZPOT@PAYTM-PYTM7290499-345307,142740.92,2022-08-02T18:06:55+05:30,,OTHER,,2022-08-02
DEBIT,126.0,UPI-PLAYERZPOT MEDIA PVT-PLAYERZPOT@PAYTM-PYTM6323195-626012,142614.92,2022-08-02T18:14:54+05:30,,OTHER,,2022-08-02
CREDIT,525.0,UPI-ANUSHKA SHARMA-1262562508@APL-SBIN8468094-83352195,143139.92,2022-08-03T09:48:14+05:30,,OTHER,,2022-08-03
DEBIT,525.0,UPI-Akshay Thakur-CSL-FZ.AIRPAY@SBI-SBIN7107468-461088014064-NA,142614.92,2022-08-03T09:59:32+05:30,,OTHER,,2022-08-03
CREDIT,1050.0,IMPS-637901019626-Tanaia Ma-ICIC-XXXXXXXX3110-TRA,143664.92,2022-08-03T14:04:13+05:30,,OTHER,,2022-08-03
DEBIT,183.75,UPI-PLAYERZPOT MEDIA PVT-PLAYERZPOT@PAYTM-PYTM3935494-370227,143481.17,2022-08-03T14:14:31+05:30,,OTHER,,2022-08-03
DEBIT,236.25,UPI-PLAYERZPOT MEDIA PVT-PLAYERZPOT@PAYTM-PYTM7737895-369219,143244.92,2022-08-03T18:04:22+05:30,,OTHER,,2022-08-03
CREDIT,435.75,IMPS-599412764183-Deven Nayak PVT LTD-YESB-XXXXXXXXXXX9963-PLAYERZP,143680.67,2022-08-03T18:37:22+05:30,,OTHER,,2022-08-03
DEBIT,624.75,UPI-PLAYERZPOT MEDIA PVT-PLAYERZPOT@PAYTM-PYTM5138316-340260,143055.92,2022-08-04T05:22:00+05:30,,OTHER,,2022-08-04
CREDIT,2756.25,IMPS-547072276623-Ashwin Ram PVT LTD-YESB-XXXXXXXXXXX3919-PLAYERZP,145812.17,2022-08-04T19:11:07+05:30,,OTHER,,2022-08-04
DEBIT,126.0,UPI-PLAYERZPOT MEDIA PVT-PLAYERZPOT@PAYTM-PYTM8487813-493892,145686.17,2022-08-05T08:44:00+05:30,,OTHER,,2022-08-05
DEBIT,525.0,UPI-Shaleena Chand-CSL-FZ.AIRPAY@SBI-SBIN6374563-472264239825-NA,145161.17,2022-08-05T08:53:56+05:30,,OTHER,,2022-08-05
DEBIT,1000.0,ACH D- TP ACH INVESCO MF-351292869,144161.17,2022-08-05T09:02:33+05:30,,OTHER,,2022-08-05
DEBIT,1.73,INSTA ALERT CHARGES(MAR-34) - SMS 549459-MIR4750143568944,144159.44,2022-08-07T04:11:54+05:30,,OTHER,,2022-08-07
CREDIT,52.5,UPI-JENISH VEKARIYA-4025187341@YBL-HDFC8899095-507711438295,144211.94,2022-08-07T11:47:25+05:30,,OTHER,,2022-08-07
CREDIT,4725.0,UPI-ANUSHKA SHARMA-0982960137@APL-SBIN8278787-38949337,148936.94,2022-08-08T04:37:59+05:30,,OTHER,,2022-08-08
DEBIT,2100.0,ATW-040838XXXXXX2900-P3ENJP71-E SINGHBHUM,146836.94,2022-08-08T04:38:05+05:30,,OTHER,,2022-08-08
DEBIT,2100.0,ATW-388909XXXXXX1297-P7ENJP90-E SINGHBHUM,144736.94,2022-08-08T04:40:01+05:30,,OTHER,,2022-08-08
DEBIT,624.75,UPI-PLAYERZPOT MEDIA PVT-PLAYERZPOT@PAYTM-PYTM4506880-350623,144112.19,2022-08-10T07:50:25+05:30,,OTHER,,2022-08-10
CREDIT,52282.65,NEFT CR-BOFA0ND6316-PIRIMID FINTECH INDIA PVT LTD-KEVAL PUROHIT RAI-534,196394.84,2022-08-10T09:26:32+05:30,,OTHER,,2022-08-10
DEBIT,7535.57,IB BILLPAY DR-HDFCCC-100267XXXXXX2073,188859.27,2022-08-10T09:35:25+05:30,,OTHER,,2022-08-10
DEBIT,5250.0,NWD-063213XXXXXX7684-A5214678-PURBI SINGHBH,183609.27,2022-08-10T10:26:39+05:30,,OTHER,,2022-08-10
DEBIT,986.0,EBANK:BBPS/1321416948/HGA6P030F70027752589#BB0122,182623.27,2022-08-10T10:26:39+05:30,,OTHER,,2022-08-10
CREDIT,40.71,APBS-CR/HPCL LPG Subsidy/P102203B10A62,182663.98,2022-08-10T10:26:39+05:30,,OTHER,,2022-08-10
CREDIT,100.0,ACH C- AMARARAJAINT1DIV2022-WN271792 CL,182763.98,2022-08-10T10:26:39+05:30,,OTHER,,2022-08-10
CREDIT,7000.0,FD PREMAT PROCEEDS: 1546215634,189763.98,2022-08-10T10:26:39+05:30,,OTHER,,2022-08-10
DEBIT,2194.5,UPI-PLAYERZPOT MEDIA PVT-PLAYERZPOT@PAYTM-PYTM5306908-469613,187569.48,2022-08-10T17:01:45+05:30,,OTHER,,2022-08-10
DEBIT,7875.0,IB BILLPAY DR-HDFCYA-877183XXXXXX9796,179694.48,2022-08-10T17:58:22+05:30,,OTHER,,2022-08-10
CREDIT,57.75,CREDIT INTEREST CAPITALISED,179752.23,2022-08-10T21:32:45+05:30,,OTHER,,2022-08-10
DEBIT,183.75,UPI-PLAYERZPOT MEDIA PVT-PLAYERZPOT@PAYTM-PYTM6528408-669434,179568.48,2022-08-11T03:19:15+05:30,,OTHER,,2022-08-11
CREDIT,2940.0,UPI-RUTVIK SINGH-RUTVIK.SINGH000@OKICICI-ICIC972,182508.48,2022-08-11T05:45:45+05:30,,OTHER,,2022-08-11
DEBIT,5250.0,UPI-DEEPIKA PADUKON-5198417704@IBL-KKBK2305783-68555632,177258.48,2022-08-11T10:57:09+05:30,,OTHER,,2022-08-11
DEBIT,100000.0,NEFT DR-BOFA0ND6316-RAHI SHAH-KEVAL PUROHIT-1235,77258.48,2022-08-11T10:57:15+05:30,,OTHER,,2022-08-11
DEBIT,5250.0,UPI-ANUSHKA SHARMA-4189362899@YBL-SBIN3796581-70373607,72008.48,2022-08-11T10:57:35+05:30,,OTHER,,2022-08-11
DEBIT,525.0,UPI-KIRAN BHANUSHALI-2634918401@YBL-SBIN6557183-682662405341,71483.48,2022-08-11T11:49:35+05:30,,OTHER,,2022-08-11
CREDIT,1.73,REV_INSTA ALERT CHG(MAR-04) - SMS 216315-MIR9997110838604,71485.21,2022-08-11T14:23:14+05:30,,OTHER,,2022-08-11
DEBIT,599.76,UPI-Sahil Singh-RAZORPAYONLINE@YBL-YESB2YBLUPI-3698,70885.45,2022-08-12T12:36:29+05:30,,OTHER,,2022-08-12
DEBIT,6825.0,UPI-Damayanti Prasad-DAMAYANTI483@OKSBI-SBIN7893419-01252,64060.45,2022-08-13T12:26:58+05:30,,OTHER,,2022-08-13
DEBIT,183.75,UPI-PLAYERZPOT MEDIA PVT-PLAYERZPOT@PAYTM-PYTM3628083-400543,63876.7,2022-08-13T15:45:12+05:30,,OTHER,,2022-08-13
CREDIT,200000.0,RTGS CR-BARBR52022100100815271-PRATIBHA MISHRA-KARAN KUMAR-IDFBR929,263876.7,2022-08-13T15:50:30+05:30,,OTHER,,2022-08-13
DEBIT,1200.0,MBK/226899200378/20:47:24/self,262676.7,2022-08-13T15:51:30+05:30,,OTHER,,2022-08-13
DEBIT,1000.0,EBANK:SELF/1318644608/,261676.7,2022-08-13T15:52:30+05:30,,OTHER,,2022-08-13
DEBIT,570.0,MBK/230455326479/15:14:54/ SELF,261106.7,2022-08-13T15:53:30+05:30,,OTHER,,2022-08-13
DEBIT,600.0,EBANK:WIB/1318644072/,260506.7,2022-08-13T15:54:30+05:30,,OTHER,,2022-08-13
CREDIT,1081.5,IMPS-312051797741-Tulsi Thakur PVT LTD-YESB-XXXXXXXXXXX5367-PLAYERZP,261588.2,2022-08-13T18:46:33+05:30,,OTHER,,2022-08-13
DEBIT,210.0,UPI-KIRAN BHANUSHALI-9878879907@YBL-SBIN1045958-950957516829,261378.2,2022-08-14T07:56:30+05:30,,OTHER,,2022-08-14
DEBIT,94.5,UPI-BHARATPEMERCHANT-BHARATPE.4634603035@ICICI-ICIC0DC4076-7,261283.7,2022-08-14T08:29:50+05:30,,OTHER,,2022-08-14
DEBIT,16800.0,UPI-Anila Begam-ANILABEGAM104@YBL-SBIN3376517-192473844122-,244483.7,2022-08-14T09:26:34+05:30,,OTHER,,2022-08-14
DEBIT,2.1,743845320484447959- Kamala Ram,244481.6,2022-08-14T12:12:36+05:30,,OTHER,,2022-08-14
CREDIT,5.0,UPI-GOOGLEPAY-GOOG-PAYMENT@OKAXIS-UTIB0375206-129756135467-R,244486.6,2022-08-14T12:13:36+05:30,,OTHER,,2022-08-14
DEBIT,201000.0,RTGS DR-N229222081617470-RAHUL MISHRA-KARAN KUMAR-IDFBR929,43486.6,2022-06-14T13:28:58+05:30,,OTHER,,2022-06-14
DEBIT,15.75,UPI-PLAYERZPOT MEDIA PVT-PLAYERZPOT@PAYTM-PYTM1068563-417420,43470.85,2022-08-14T16:42:11+05:30,,OTHER,,2022-08-14
